NOC,Sport,Gold,Silver,Bronze,Total
AFG,Taekwondo,0,0,2,2
AHO,Sailing,0,1,0,1
AIN,Rowing,0,1,0,1
AIN,Tennis,0,2,0,2
AIN,Trampoline Gymnastics,1,1,0,2
AIN,Weightlifting,0,0,1,1
ALB,Wrestling,0,0,2,2
ALG,Artistic Gymnastics,1,0,0,1
ALG,Athletics,4,3,3,10
ALG,Boxing,2,0,5,7
ALG,Judo,0,1,1,2
ANZ,Athletics,0,0,1,1
ANZ,Boxing,0,1,0,1
ANZ,Rugby,15,0,0,15
ANZ,Swimming,5,3,3,11
ANZ,Tennis,0,0,1,1
ARG,Athletics,2,3,0,5
ARG,Basketball,12,0,12,24
ARG,Boxing,7,7,10,24
ARG,Cycling,2,0,0,2
ARG,Cycling BMX Freestyle,1,0,0,1
ARG,Equestrianism,0,1,0,1
ARG,Fencing,0,0,5,5
ARG,Football,34,34,0,68
ARG,Hockey,18,49,48,115
ARG,Judo,1,0,1,2
ARG,Polo,9,0,0,9
ARG,Rowing,2,1,3,6
ARG,Rugby Sevens,0,0,13,13
ARG,Sailing,2,12,9,23
ARG,Shooting,0,1,0,1
ARG,Swimming,1,1,1,3
ARG,Taekwondo,1,0,0,1
ARG,Tennis,0,2,5,7
ARG,Volleyball,0,0,24,24
ARG,Weightlifting,0,1,1,2
ARM,Artistic Gymnastics,0,1,1,2
ARM,Boxing,0,0,2,2
ARM,Weightlifting,0,4,5,9
ARM,Wrestling,2,5,4,11
AUS,Archery,1,0,4,5
AUS,Athletics,25,40,35,100
AUS,Baseball,0,24,0,24
AUS,Basketball,0,36,47,83
AUS,Beach Volleyball,2,2,2,6
AUS,Boxing,0,1,6,7
AUS,Canoe Slalom,4,0,1,5
AUS,Canoe Sprint,2,4,2,8
AUS,Canoeing,6,10,25,41
AUS,Cycling,26,29,29,84
AUS,Cycling BMX Freestyle,1,0,1,2
AUS,Cycling BMX Racing,1,0,0,1
AUS,Cycling Road,1,0,1,2
AUS,Cycling Track,5,2,11,18
AUS,Diving,3,5,14,22
AUS,Equestrian,0,5,1,6
AUS,Equestrianism,18,7,12,37
AUS,Hockey,64,63,79,206
AUS,Judo,0,0,2,2
AUS,Marathon Swimming,0,0,1,1
AUS,Modern Pentathlon,1,0,0,1
AUS,Rowing,30,56,76,162
AUS,Rugby Sevens,12,0,0,12
AUS,Sailing,26,18,14,58
AUS,Shooting,5,1,6,12
AUS,Skateboarding,3,0,0,3
AUS,Softball,0,15,45,60
AUS,Surfing,0,1,1,2
AUS,Swimming,155,184,166,505
AUS,Taekwondo,1,1,0,2
AUS,Tennis,4,2,8,14
AUS,Trampolining,0,1,0,1
AUS,Triathlon,1,2,2,5
AUS,Water Polo,13,13,26,52
AUS,Weightlifting,1,1,2,4
AUS,Wrestling,0,1,2,3
AUT,Art Competitions,3,3,4,10
AUT,Athletics,1,2,5,8
AUT,Canoeing,4,7,10,21
AUT,Cycling,1,0,2,3
AUT,Cycling Road,1,0,0,1
AUT,Diving,0,0,1,1
AUT,Equestrianism,1,4,1,6
AUT,Fencing,1,7,5,13
AUT,Football,0,13,0,13
AUT,Gymnastics,2,1,0,3
AUT,Handball,0,22,0,22
AUT,Judo,2,3,3,8
AUT,Karate,0,0,1,1
AUT,Rowing,0,5,5,10
AUT,Sailing,8,5,2,15
AUT,Shooting,1,2,5,8
AUT,Sport Climbing,0,0,3,3
AUT,Swimming,2,6,9,17
AUT,Tennis,0,2,0,2
AUT,Triathlon,1,0,0,1
AUT,Weightlifting,4,5,2,11
AUT,Wrestling,1,2,3,6
AZE,Boxing,0,2,8,10
AZE,Canoeing,0,1,1,2
AZE,Judo,3,2,2,7
AZE,Karate,0,2,0,2
AZE,Shooting,1,0,2,3
AZE,Taekwondo,1,1,2,4
AZE,Weightlifting,0,0,1,1
AZE,Wrestling,4,9,16,29
BAH,Athletics,14,11,13,38
BAH,Sailing,2,0,2,4
BAR,Athletics,0,0,1,1
BDI,Athletics,1,1,0,2
BEL,Archery,35,14,3,52
BEL,Art Competitions,2,1,5,8
BEL,Artistic Gymnastics,1,0,0,1
BEL,Athletics,6,11,4,21
BEL,Boxing,1,1,2,4
BEL,Cycling,13,12,22,47
BEL,Cycling Road,2,1,1,4
BEL,Cycling Track,0,0,1,1
BEL,Equestrian,0,0,4,4
BEL,Equestrianism,7,5,11,23
BEL,Fencing,10,19,19,48
BEL,Football,14,0,9,23
BEL,Gymnastics,0,24,24,48
BEL,Hockey,18,16,14,48
BEL,Judo,2,1,11,14
BEL,Rowing,0,26,4,30
BEL,Sailing,4,8,7,19
BEL,Shooting,1,13,3,17
BEL,Swimming,1,2,2,5
BEL,Taekwondo,0,0,1,1
BEL,Tennis,1,0,2,3
BEL,Tug-Of-War,0,0,8,8
BEL,Water Polo,0,36,18,54
BEL,Weightlifting,1,2,1,4
BEL,Wrestling,0,3,1,4
BER,Boxing,0,0,1,1
BER,Triathlon,1,0,0,1
BLR,Athletics,4,6,8,18
BLR,Boxing,0,2,0,2
BLR,Canoe Sprint,0,4,0,4
BLR,Canoeing,6,4,12,22
BLR,Cycling,0,0,1,1
BLR,Gymnastics,0,0,4,4
BLR,Judo,1,0,1,2
BLR,Modern Pentathlon,0,0,1,1
BLR,Rhythmic Gymnastics,0,14,8,22
BLR,Rowing,2,1,14,17
BLR,Shooting,1,2,4,7
BLR,Swimming,0,2,1,3
BLR,Tennis,2,0,1,3
BLR,Trampoline Gymnastics,1,0,0,1
BLR,Trampolining,1,0,0,1
BLR,Weightlifting,1,5,6,12
BLR,Wrestling,0,6,8,14
BOH,Athletics,0,1,0,1
BOH,Fencing,0,0,6,6
BOH,Tennis,0,0,5,5
BOT,Athletics,1,7,6,14
BRA,Artistic Gymnastics,2,3,5,10
BRA,Athletics,5,8,17,30
BRA,Basketball,0,12,46,58
BRA,Beach Volleyball,8,14,6,28
BRA,Boxing,2,2,5,9
BRA,Canoe Sprint,1,1,0,2
BRA,Canoeing,0,3,1,4
BRA,Equestrianism,1,0,8,9
BRA,Football,39,107,34,180
BRA,Gymnastics,1,2,1,4
BRA,Judo,5,4,28,37
BRA,Marathon Swimming,1,0,0,1
BRA,Modern Pentathlon,0,0,1,1
BRA,Sailing,14,6,16,36
BRA,Shooting,1,2,5,8
BRA,Skateboarding,0,3,2,5
BRA,Surfing,1,1,1,3
BRA,Swimming,1,4,17,22
BRA,Taekwondo,0,0,3,3
BRA,Tennis,0,0,2,2
BRA,Volleyball,60,48,37,145
BRN,Athletics,2,3,1,6
BRN,Weightlifting,0,0,1,1
BRN,Wrestling,1,0,0,1
BUL,Athletics,5,8,6,19
BUL,Basketball,0,12,12,24
BUL,Boxing,5,5,10,20
BUL,Canoeing,4,6,18,28
BUL,Equestrianism,0,3,0,3
BUL,Football,0,18,14,32
BUL,Gymnastics,2,2,6,10
BUL,Judo,0,1,2,3
BUL,Karate,1,0,0,1
BUL,Rhythmic Gymnastics,5,8,11,24
BUL,Rowing,5,13,16,34
BUL,Shooting,4,7,6,17
BUL,Swimming,1,1,1,3
BUL,Taekwondo,0,0,1,1
BUL,Tennis,0,0,1,1
BUL,Volleyball,0,12,10,22
BUL,Weightlifting,13,16,9,38
BUL,Wrestling,18,32,23,73
BUR,Athletics,0,0,1,1
CAN,Art Competitions,0,1,1,2
CAN,Athletics,32,28,60,120
CAN,Baseball/Softball,0,0,15,15
CAN,Basketball,0,9,0,9
CAN,Beach Volleyball,0,2,2,4
CAN,Boxing,3,7,8,18
CAN,Breaking,1,0,0,1
CAN,Canoe Sprint,1,1,4,6
CAN,Canoeing,5,13,15,33
CAN,Cycling,1,5,17,23
CAN,Cycling Track,1,0,1,2
CAN,Diving,1,7,14,22
CAN,Equestrianism,4,5,8,17
CAN,Fencing,0,0,1,1
CAN,Football,35,0,36,71
CAN,Golf,1,0,0,1
CAN,Gymnastics,1,0,0,1
CAN,Ice Hockey,8,0,0,8
CAN,Judo,1,2,5,8
CAN,Lacrosse,24,0,12,36
CAN,Rhythmic Gymnastics,1,0,0,1
CAN,Rowing,59,99,65,223
CAN,Rugby Sevens,0,14,12,26
CAN,Sailing,0,10,15,25
CAN,Shooting,4,13,7,24
CAN,Swimming,12,34,75,121
CAN,Synchronized Swimming,4,14,8,26
CAN,Taekwondo,0,1,2,3
CAN,Tennis,2,0,2,4
CAN,Trampoline Gymnastics,0,0,1,1
CAN,Trampolining,2,3,2,7
CAN,Triathlon,1,1,0,2
CAN,Weightlifting,1,3,1,5
CAN,Wrestling,3,7,7,17
CHI,Athletics,0,2,0,2
CHI,Boxing,0,1,2,3
CHI,Equestrianism,0,4,0,4
CHI,Football,0,0,17,17
CHI,Shooting,1,1,0,2
CHI,Tennis,3,1,1,5
CHI,Wrestling,0,1,0,1
CHN,3x3 Basketball,0,0,4,4
CHN,Archery,1,17,4,22
CHN,Artistic Gymnastics,5,12,7,24
CHN,Artistic Swimming,11,10,0,21
CHN,Athletics,11,8,17,36
CHN,Badminton,35,25,23,83
CHN,Basketball,0,11,12,23
CHN,Beach Volleyball,0,2,2,4
CHN,Boxing,6,7,6,19
CHN,Breaking,0,0,1,1
CHN,Canoe Sprint,6,3,0,9
CHN,Canoeing,4,0,0,4
CHN,Cycling,2,4,3,9
CHN,Cycling BMX Freestyle,1,0,0,1
CHN,Cycling Track,3,0,0,3
CHN,Diving,78,29,12,119
CHN,Fencing,8,18,5,31
CHN,Football,0,15,0,15
CHN,Golf,0,0,2,2
CHN,Gymnastics,45,34,30,109
CHN,Handball,0,0,13,13
CHN,Hockey,0,33,0,33
CHN,Judo,8,3,12,23
CHN,Karate,0,1,1,2
CHN,Modern Pentathlon,0,1,0,1
CHN,Rhythmic Gymnastics,5,6,0,11
CHN,Rowing,8,11,25,44
CHN,Sailing,3,3,2,8
CHN,Shooting,34,18,29,81
CHN,Softball,0,15,0,15
CHN,Sport Climbing,0,2,0,2
CHN,Swimming,27,47,46,120
CHN,Synchronized Swimming,0,20,11,31
CHN,Table Tennis,67,28,9,104
CHN,Taekwondo,7,2,4,13
CHN,Tennis,3,2,2,7
CHN,Trampoline Gymnastics,1,3,1,5
CHN,Trampolining,3,2,6,11
CHN,Volleyball,34,9,23,66
CHN,Weightlifting,46,16,8,70
CHN,Wrestling,2,6,11,19
CIV,Athletics,0,1,0,1
CIV,Taekwondo,1,0,3,4
CMR,Athletics,2,0,0,2
CMR,Boxing,0,1,1,2
CMR,Football,18,0,0,18
COL,Artistic Gymnastics,0,1,0,1
COL,Athletics,1,3,1,5
COL,Boxing,0,1,4,5
COL,Cycling,2,1,3,6
COL,Cycling BMX Racing,0,1,1,2
COL,Judo,0,1,1,2
COL,Shooting,0,2,0,2
COL,Taekwondo,0,0,1,1
COL,Tug-Of-War,0,1,0,1
COL,Weightlifting,2,5,2,9
COL,Wrestling,0,0,3,3
CPV,Boxing,0,0,1,1
CRC,Swimming,1,1,2,4
CRO,Artistic Gymnastics,0,1,0,1
CRO,Athletics,3,1,2,6
CRO,Basketball,0,12,0,12
CRO,Boxing,0,0,1,1
CRO,Gymnastics,0,1,0,1
CRO,Handball,31,0,15,46
CRO,Judo,1,0,0,1
CRO,Rowing,6,7,10,23
CRO,Sailing,2,2,0,4
CRO,Shooting,2,0,2,4
CRO,Swimming,0,1,0,1
CRO,Taekwondo,1,0,5,6
CRO,Tennis,2,3,5,10
CRO,Water Polo,13,38,0,51
CRO,Weightlifting,1,0,1,2
CUB,Athletics,10,24,27,61
CUB,Baseball,64,48,0,112
CUB,Basketball,0,0,12,12
CUB,Boxing,42,19,19,80
CUB,Canoe Sprint,2,0,1,3
CUB,Canoeing,0,5,0,5
CUB,Cycling,0,1,0,1
CUB,Fencing,6,7,7,20
CUB,Judo,6,15,16,37
CUB,Sailing,0,2,0,2
CUB,Shooting,1,1,3,5
CUB,Swimming,0,1,1,2
CUB,Taekwondo,1,2,4,7
CUB,Volleyball,28,0,24,52
CUB,Weightlifting,2,1,2,5
CUB,Wrestling,12,7,11,30
CYP,Sailing,0,2,0,2
CZE,Athletics,5,2,8,15
CZE,Boxing,0,1,0,1
CZE,Canoe Slalom,1,1,0,2
CZE,Canoe Sprint,2,0,2,4
CZE,Canoeing,4,7,13,24
CZE,Cycling,1,1,0,2
CZE,Fencing,0,0,5,5
CZE,Judo,2,0,0,2
CZE,Modern Pentathlon,1,0,1,2
CZE,Rowing,1,6,1,8
CZE,Sailing,0,1,0,1
CZE,Shooting,3,4,4,11
CZE,Tennis,4,5,6,15
CZE,Triathlon,0,0,1,1
DEN,Art Competitions,0,5,4,9
DEN,Athletics,0,4,3,7
DEN,Badminton,3,5,6,14
DEN,Boxing,1,5,6,12
DEN,Canoe Sprint,0,0,3,3
DEN,Canoeing,4,9,9,22
DEN,Cycling,14,16,22,52
DEN,Cycling Track,2,8,1,11
DEN,Diving,1,0,1,2
DEN,Equestrian,0,4,0,4
DEN,Equestrianism,0,4,4,8
DEN,Fencing,1,2,3,6
DEN,Football,12,40,13,65
DEN,Gymnastics,20,71,20,111
DEN,Handball,75,15,15,105
DEN,Hockey,0,12,0,12
DEN,Rowing,26,13,42,81
DEN,Sailing,25,25,18,68
DEN,Shooting,7,11,10,28
DEN,Swimming,3,9,10,22
DEN,Table Tennis,0,0,2,2
DEN,Taekwondo,0,0,1,1
DEN,Tennis,0,1,0,1
DEN,Tug-Of-War,3,0,0,3
DEN,Weightlifting,1,2,0,3
DEN,Wrestling,2,4,8,14
DJI,Athletics,0,0,1,1
DMA,Athletics,1,0,0,1
DOM,Athletics,3,7,0,10
DOM,Baseball/Softball,0,0,24,24
DOM,Boxing,1,0,3,4
DOM,Taekwondo,0,1,1,2
DOM,Weightlifting,0,1,1,2
ECU,Athletics,2,3,0,5
ECU,Cycling Road,1,0,0,1
ECU,Weightlifting,1,1,2,4
ECU,Wrestling,0,1,0,1
EGY,Boxing,0,1,2,3
EGY,Diving,0,1,1,2
EGY,Fencing,0,1,1,2
EGY,Judo,0,1,1,2
EGY,Karate,1,0,1,2
EGY,Modern Pentathlon,1,1,0,2
EGY,Taekwondo,0,0,4,4
EGY,Weightlifting,5,3,4,12
EGY,Wrestling,2,2,3,7
EOR,Boxing,0,0,1,1
ERI,Athletics,0,0,1,1
ESP,3x3 Basketball,0,4,0,4
ESP,Archery,3,0,0,3
ESP,Artistic Gymnastics,0,1,0,1
ESP,Artistic Swimming,0,0,9,9
ESP,Athletics,6,6,8,20
ESP,Badminton,1,0,0,1
ESP,Basketball,0,48,12,60
ESP,Basque Pelota,2,0,0,2
ESP,Beach Volleyball,0,2,0,2
ESP,Boxing,0,3,3,6
ESP,Canoe Slalom,0,1,1,2
ESP,Canoe Sprint,0,5,6,11
ESP,Canoeing,7,11,6,24
ESP,Cycling,5,6,8,19
ESP,Cycling Mountain Bike,0,0,1,1
ESP,Equestrianism,3,7,1,11
ESP,Fencing,0,0,1,1
ESP,Football,39,57,0,96
ESP,Gymnastics,2,1,1,4
ESP,Handball,0,0,91,91
ESP,Hockey,15,48,14,77
ESP,Judo,3,1,3,7
ESP,Karate,1,1,0,2
ESP,Polo,0,5,0,5
ESP,Rhythmic Gymnastics,6,6,0,12
ESP,Rowing,0,2,0,2
ESP,Sailing,26,8,4,38
ESP,Shooting,2,2,1,5
ESP,Sport Climbing,1,0,0,1
ESP,Swimming,2,2,4,8
ESP,Synchronized Swimming,0,12,8,20
ESP,Taekwondo,1,5,1,7
ESP,Tennis,3,12,8,23
ESP,Triathlon,0,1,0,1
ESP,Water Polo,25,37,0,62
ESP,Weightlifting,0,0,1,1
ESP,Wrestling,0,0,1,1
EST,Athletics,2,1,3,6
EST,Boxing,0,1,0,1
EST,Cycling,1,0,0,1
EST,Fencing,4,0,1,5
EST,Judo,0,0,3,3
EST,Rowing,0,3,4,7
EST,Sailing,0,0,7,7
EST,Weightlifting,1,3,3,7
EST,Wrestling,5,2,4,11
ETH,Athletics,24,13,24,61
EUN,Archery,0,0,4,4
EUN,Athletics,12,14,3,29
EUN,Basketball,12,0,0,12
EUN,Boxing,0,1,1,2
EUN,Canoeing,2,1,0,3
EUN,Diving,0,2,1,3
EUN,Fencing,5,2,6,13
EUN,Gymnastics,19,5,4,28
EUN,Handball,12,0,13,25
EUN,Judo,2,0,2,4
EUN,Modern Pentathlon,0,3,1,4
EUN,Rhythmic Gymnastics,1,0,1,2
EUN,Rowing,0,0,4,4
EUN,Shooting,5,2,1,8
EUN,Swimming,11,14,5,30
EUN,Tennis,0,0,3,3
EUN,Volleyball,0,8,0,8
EUN,Water Polo,0,0,13,13
EUN,Weightlifting,5,4,0,9
EUN,Wrestling,6,5,5,16
FIJ,Rugby Sevens,26,14,13,53
FIN,Archery,1,3,2,6
FIN,Art Competitions,3,1,1,5
FIN,Athletics,64,42,32,138
FIN,Boxing,2,1,13,16
FIN,Canoeing,7,2,5,14
FIN,Figure Skating,2,0,0,2
FIN,Gymnastics,15,24,60,99
FIN,Modern Pentathlon,0,1,10,11
FIN,Rowing,3,2,11,16
FIN,Sailing,3,8,24,35
FIN,Shooting,4,11,26,41
FIN,Swimming,0,1,4,5
FIN,Weightlifting,1,0,2,3
FIN,Wrestling,27,29,29,85
FRA,3x3 Basketball,0,4,0,4
FRA,Archery,7,28,17,52
FRA,Art Competitions,6,4,5,15
FRA,Athletics,14,42,62,118
FRA,Basketball,0,74,12,86
FRA,Boxing,6,11,11,28
FRA,Breaking,0,1,0,1
FRA,Canoe Slalom,1,2,0,3
FRA,Canoeing,10,12,31,53
FRA,Cricket,0,3,0,3
FRA,Croquet,4,2,2,8
FRA,Cycling,69,39,43,151
FRA,Cycling BMX Freestyle,0,0,1,1
FRA,Cycling BMX Racing,1,1,1,3
FRA,Cycling Mountain Bike,1,1,0,2
FRA,Cycling Road,0,1,1,2
FRA,Cycling Track,1,0,7,8
FRA,Diving,0,1,0,1
FRA,Equestrian,0,4,7,11
FRA,Equestrianism,32,26,21,79
FRA,Fencing,135,107,98,340
FRA,Football,16,37,0,53
FRA,Gymnastics,5,17,36,58
FRA,Handball,62,48,16,126
FRA,Judo,41,15,34,90
FRA,Karate,1,0,0,1
FRA,Modern Pentathlon,0,2,6,8
FRA,Motorboating,1,0,0,1
FRA,Polo,0,1,3,4
FRA,Rowing,22,50,51,123
FRA,Rugby,15,34,0,49
FRA,Rugby Sevens,13,13,0,26
FRA,Sailing,30,42,52,124
FRA,Shooting,13,28,30,71
FRA,Surfing,1,0,1,2
FRA,Swimming,17,35,41,93
FRA,Synchronized Swimming,0,0,2,2
FRA,Table Tennis,0,1,6,7
FRA,Taekwondo,1,3,6,10
FRA,Tennis,12,11,15,38
FRA,Triathlon,1,0,6,7
FRA,Tug-Of-War,0,5,0,5
FRA,Volleyball,25,0,0,25
FRA,Water Polo,7,0,23,30
FRA,Weightlifting,9,3,4,16
FRA,Wrestling,4,4,9,17
FRG,Athletics,15,17,39,71
FRG,Boxing,1,0,5,6
FRG,Canoeing,3,7,4,14
FRG,Cycling,11,9,8,28
FRG,Equestrianism,29,13,20,62
FRG,Fencing,23,24,1,48
FRG,Football,0,0,18,18
FRG,Gymnastics,0,0,1,1
FRG,Handball,0,15,0,15
FRG,Hockey,18,48,0,66
FRG,Judo,1,4,3,8
FRG,Rhythmic Gymnastics,0,0,1,1
FRG,Rowing,28,4,19,51
FRG,Sailing,4,4,6,14
FRG,Shooting,4,4,3,11
FRG,Swimming,3,17,39,59
FRG,Tennis,1,0,2,3
FRG,Water Polo,0,0,12,12
FRG,Weightlifting,2,2,3,7
FRG,Wrestling,1,4,4,9
GAB,Taekwondo,0,1,0,1
GBR,Archery,2,2,9,13
GBR,Art Competitions,3,5,1,9
GBR,Artistic Gymnastics,1,0,6,7
GBR,Artistic Swimming,0,2,0,2
GBR,Athletics,79,150,164,393
GBR,Badminton,0,2,4,6
GBR,Boxing,20,15,28,63
GBR,Canoe Slalom,0,3,2,5
GBR,Canoe Sprint,0,0,1,1
GBR,Canoeing,6,10,6,22
GBR,Cricket,12,9,0,21
GBR,Cycling,59,68,55,182
GBR,Cycling BMX Freestyle,1,1,1,3
GBR,Cycling BMX Racing,1,1,0,2
GBR,Cycling Mountain Bike,1,0,0,1
GBR,Cycling Road,0,1,0,1
GBR,Cycling Track,8,23,10,41
GBR,Diving,4,6,16,26
GBR,Equestrian,13,1,11,25
GBR,Equestrianism,26,34,23,83
GBR,Fencing,1,27,0,28
GBR,Figure Skating,1,3,6,10
GBR,Football,36,8,1,45
GBR,Golf,1,2,1,4
GBR,Gymnastics,2,3,46,51
GBR,Hockey,57,24,100,181
GBR,Jeu De Paume,0,1,1,2
GBR,Judo,0,8,12,20
GBR,Lacrosse,0,12,0,12
GBR,Modern Pentathlon,6,2,5,13
GBR,Motorboating,6,0,0,6
GBR,Polo,11,14,5,30
GBR,Racquets,3,3,4,10
GBR,Rowing,124,129,66,319
GBR,Rugby,0,30,0,30
GBR,Rugby Sevens,0,12,0,12
GBR,Sailing,77,50,26,153
GBR,Shooting,30,37,35,102
GBR,Skateboarding,0,0,2,2
GBR,Sport Climbing,1,0,0,1
GBR,Swimming,41,60,56,157
GBR,Taekwondo,2,4,4,10
GBR,Tennis,25,23,19,67
GBR,Trampoline Gymnastics,1,0,1,2
GBR,Trampolining,0,1,0,1
GBR,Triathlon,8,3,3,14
GBR,Tug-Of-War,16,16,8,40
GBR,Water Polo,27,0,1,28
GBR,Weightlifting,1,4,4,9
GBR,Wrestling,3,4,10,17
GDR,Athletics,50,51,39,140
GDR,Boxing,5,2,6,13
GDR,Canoeing,24,11,17,52
GDR,Cycling,9,20,4,33
GDR,Diving,2,2,3,7
GDR,Fencing,0,1,0,1
GDR,Football,17,17,17,51
GDR,Gymnastics,6,28,52,86
GDR,Handball,14,14,14,42
GDR,Judo,1,2,6,9
GDR,Rowing,139,24,21,184
GDR,Sailing,4,5,6,15
GDR,Shooting,3,8,5,16
GDR,Swimming,62,61,29,152
GDR,Volleyball,0,24,0,24
GDR,Weightlifting,1,4,6,11
GDR,Wrestling,2,3,2,7
GEO,Boxing,0,0,2,2
GEO,Judo,5,7,3,15
GEO,Shooting,0,0,1,1
GEO,Weightlifting,4,0,3,7
GEO,Wrestling,4,7,11,22
GER,3x3 Basketball,4,0,0,4
GER,Alpinism,2,0,0,2
GER,Archery,0,6,6,12
GER,Art Competitions,9,8,9,26
GER,Artistic Gymnastics,0,1,0,1
GER,Athletics,27,68,70,165
GER,Beach Volleyball,4,2,2,8
GER,Boxing,5,12,13,30
GER,Canoe Slalom,1,1,4,6
GER,Canoe Sprint,10,6,4,20
GER,Canoeing,77,53,33,163
GER,Cycling,33,31,30,94
GER,Cycling Track,6,4,4,14
GER,Diving,6,12,16,34
GER,Equestrian,13,2,0,15
GER,Equestrianism,77,32,34,143
GER,Fencing,19,16,38,73
GER,Figure Skating,2,1,0,3
GER,Football,18,17,89,124
GER,Golf,0,1,0,1
GER,Gymnastics,46,12,19,77
GER,Handball,22,31,15,68
GER,Hockey,65,56,79,200
GER,Judo,3,5,27,35
GER,Marathon Swimming,1,0,0,1
GER,Modern Pentathlon,2,0,1,3
GER,Rhythmic Gymnastics,1,0,0,1
GER,Rowing,106,75,71,252
GER,Rugby,0,15,0,15
GER,Sailing,10,14,22,46
GER,Shooting,11,9,11,31
GER,Swimming,18,59,83,160
GER,Table Tennis,0,11,9,20
GER,Taekwondo,0,1,1,2
GER,Tennis,6,7,3,16
GER,Trampolining,1,0,1,2
GER,Triathlon,1,1,0,2
GER,Tug-Of-War,8,0,1,9
GER,Water Polo,8,19,0,27
GER,Weightlifting,6,7,12,25
GER,Wrestling,6,18,14,38
GHA,Boxing,0,1,3,4
GHA,Football,0,0,20,20
GRE,Art Competitions,1,0,0,1
GRE,Artistic Gymnastics,0,0,2,2
GRE,Athletics,10,14,16,40
GRE,Cycling,1,3,0,4
GRE,Diving,2,0,0,2
GRE,Fencing,3,6,3,12
GRE,Football,0,0,11,11
GRE,Gymnastics,6,2,4,12
GRE,Judo,1,0,2,3
GRE,Rhythmic Gymnastics,0,0,6,6
GRE,Rowing,18,27,15,60
GRE,Sailing,6,2,8,16
GRE,Shooting,6,11,8,25
GRE,Swimming,1,5,2,8
GRE,Taekwondo,1,3,0,4
GRE,Tennis,1,8,4,13
GRE,Tug-Of-War,0,8,0,8
GRE,Water Polo,0,26,0,26
GRE,Weightlifting,7,5,4,16
GRE,Wrestling,1,3,8,12
GRN,Athletics,1,1,3,5
GUA,Athletics,0,1,0,1
GUA,Shooting,1,0,1,2
GUY,Boxing,0,0,1,1
HAI,Athletics,0,1,0,1
HAI,Rugby,1,0,0,1
HAI,Shooting,0,0,5,5
HKG,Cycling,0,0,1,1
HKG,Cycling Track,0,0,1,1
HKG,Fencing,3,0,0,3
HKG,Karate,0,0,1,1
HKG,Sailing,1,0,0,1
HKG,Swimming,0,2,2,4
HKG,Table Tennis,0,2,3,5
HUN,Art Competitions,1,3,1,5
HUN,Athletics,11,16,26,53
HUN,Boxing,10,2,8,20
HUN,Canoe Sprint,6,8,9,23
HUN,Canoeing,52,62,44,158
HUN,Equestrianism,0,0,1,1
HUN,Fencing,108,65,78,251
HUN,Football,46,17,16,79
HUN,Gymnastics,20,46,45,111
HUN,Handball,0,15,30,45
HUN,Judo,1,3,6,10
HUN,Karate,0,0,1,1
HUN,Marathon Swimming,1,1,0,2
HUN,Modern Pentathlon,18,12,10,40
HUN,Rowing,0,4,4,8
HUN,Sailing,0,1,2,3
HUN,Shooting,7,3,8,18
HUN,Swimming,39,34,26,99
HUN,Taekwondo,1,0,0,1
HUN,Tennis,0,0,1,1
HUN,Water Polo,107,29,62,198
HUN,Weightlifting,2,9,9,20
HUN,Wrestling,20,17,20,57
INA,Archery,0,3,0,3
INA,Badminton,13,9,10,32
INA,Sport Climbing,1,0,0,1
INA,Weightlifting,1,6,7,14
IND,Athletics,1,3,0,4
IND,Badminton,0,1,2,3
IND,Boxing,0,0,3,3
IND,Hockey,130,13,64,207
IND,Shooting,1,2,5,8
IND,Tennis,0,0,1,1
IND,Weightlifting,0,1,1,2
IND,Wrestling,0,2,6,8
IOA,Shooting,1,1,3,5
IRI,Athletics,0,1,0,1
IRI,Karate,1,0,0,1
IRI,Shooting,1,0,0,1
IRI,Taekwondo,3,3,4,10
IRI,Weightlifting,7,6,6,19
IRI,Wrestling,12,19,24,55
IRL,Art Competitions,0,1,2,3
IRL,Artistic Gymnastics,1,0,0,1
IRL,Athletics,4,2,0,6
IRL,Boxing,4,5,10,19
IRL,Equestrianism,0,0,1,1
IRL,Rowing,4,2,6,12
IRL,Sailing,0,3,0,3
IRL,Swimming,3,0,2,5
IRQ,Weightlifting,0,0,1,1
ISL,Athletics,0,1,1,2
ISL,Handball,0,14,0,14
ISL,Judo,0,0,1,1
ISR,Artistic Gymnastics,1,1,0,2
ISR,Canoeing,0,0,1,1
ISR,Judo,0,3,16,19
ISR,Rhythmic Gymnastics,1,5,0,6
ISR,Sailing,2,1,2,5
ISR,Taekwondo,0,0,1,1
ISV,Sailing,0,1,0,1
ITA,Archery,4,7,6,17
ITA,Art Competitions,5,7,2,14
ITA,Artistic Gymnastics,1,6,1,8
ITA,Athletics,29,19,37,85
ITA,Basketball,0,24,0,24
ITA,Beach Volleyball,0,2,0,2
ITA,Boxing,15,15,18,48
ITA,Canoe Slalom,1,0,0,1
ITA,Canoe Sprint,0,3,0,3
ITA,Canoeing,8,9,6,23
ITA,Cycling,70,34,20,124
ITA,Cycling Road,0,0,1,1
ITA,Cycling Track,8,1,5,14
ITA,Diving,3,6,3,12
ITA,Equestrianism,10,16,20,46
ITA,Fencing,155,151,81,387
ITA,Football,14,0,34,48
ITA,Gymnastics,68,18,23,109
ITA,Judo,5,4,9,18
ITA,Karate,1,0,1,2
ITA,Marathon Swimming,0,0,1,1
ITA,Modern Pentathlon,4,4,6,14
ITA,Rhythmic Gymnastics,0,6,17,23
ITA,Rowing,56,67,74,197
ITA,Sailing,14,4,13,31
ITA,Shooting,18,19,12,49
ITA,Swimming,7,11,30,48
ITA,Taekwondo,2,1,2,5
ITA,Tennis,2,0,2,4
ITA,Volleyball,13,36,36,85
ITA,Water Polo,46,37,37,120
ITA,Weightlifting,5,6,8,19
ITA,Wrestling,7,4,11,22
JAM,Athletics,48,79,56,183
JAM,Cycling,0,0,1,1
JOR,Karate,0,0,1,1
JOR,Taekwondo,1,2,0,3
JPN,Archery,0,3,8,11
JPN,Art Competitions,0,0,2,2
JPN,Artistic Gymnastics,9,4,3,16
JPN,Athletics,8,16,10,34
JPN,Badminton,2,2,7,11
JPN,Baseball,0,20,44,64
JPN,Baseball/Softball,39,0,0,39
JPN,Basketball,0,12,0,12
JPN,Boxing,3,0,5,8
JPN,Breaking,1,0,0,1
JPN,Canoeing,0,0,1,1
JPN,Cycling,0,3,3,6
JPN,Cycling Track,0,1,0,1
JPN,Diving,0,1,0,1
JPN,Equestrian,0,0,4,4
JPN,Equestrianism,1,0,0,1
JPN,Fencing,9,9,8,26
JPN,Football,0,18,16,34
JPN,Golf,0,1,1,2
JPN,Gymnastics,65,47,54,166
JPN,Hockey,0,11,0,11
JPN,Judo,51,47,30,128
JPN,Karate,1,1,1,3
JPN,Modern Pentathlon,0,1,0,1
JPN,Sailing,0,4,2,6
JPN,Shooting,1,2,3,6
JPN,Skateboarding,5,3,1,9
JPN,Softball,15,15,14,44
JPN,Sport Climbing,0,2,1,3
JPN,Surfing,0,1,1,2
JPN,Swimming,30,41,56,127
JPN,Synchronized Swimming,0,22,30,52
JPN,Table Tennis,2,12,9,23
JPN,Taekwondo,0,0,1,1
JPN,Tennis,0,3,1,4
JPN,Volleyball,36,32,33,101
JPN,Weightlifting,2,3,10,15
JPN,Wrestling,45,22,20,87
KAZ,Artistic Gymnastics,0,1,0,1
KAZ,Athletics,2,0,2,4
KAZ,Boxing,7,8,11,26
KAZ,Cycling,1,1,0,2
KAZ,Judo,1,2,3,6
KAZ,Karate,0,0,2,2
KAZ,Modern Pentathlon,1,0,0,1
KAZ,Shooting,0,2,3,5
KAZ,Swimming,1,0,0,1
KAZ,Taekwondo,0,0,1,1
KAZ,Weightlifting,6,5,7,18
KAZ,Wrestling,1,6,12,19
KEN,Athletics,41,46,33,120
KEN,Boxing,1,1,5,7
KGZ,Boxing,0,1,0,1
KGZ,Judo,0,0,1,1
KGZ,Wrestling,0,4,6,10
KOR,Archery,68,12,10,90
KOR,Artistic Gymnastics,1,0,1,2
KOR,Athletics,1,1,0,2
KOR,Badminton,12,14,14,40
KOR,Baseball,24,0,24,48
KOR,Basketball,0,11,0,11
KOR,Boxing,3,7,11,21
KOR,Fencing,16,13,17,46
KOR,Football,0,0,18,18
KOR,Golf,1,0,0,1
KOR,Gymnastics,1,4,4,9
KOR,Handball,25,57,14,96
KOR,Hockey,0,48,0,48
KOR,Judo,11,19,31,61
KOR,Modern Pentathlon,0,0,2,2
KOR,Shooting,10,13,1,24
KOR,Swimming,1,3,1,5
KOR,Table Tennis,4,6,28,38
KOR,Taekwondo,14,3,8,25
KOR,Volleyball,0,0,12,12
KOR,Weightlifting,3,5,5,13
KOR,Wrestling,11,11,14,36
KOS,Judo,3,1,1,5
KSA,Athletics,0,1,0,1
KSA,Equestrianism,0,0,5,5
KSA,Karate,0,1,0,1
KUW,Shooting,0,0,3,3
LAT,3x3 Basketball,4,0,0,4
LAT,Athletics,0,4,1,5
LAT,Beach Volleyball,0,0,2,2
LAT,Canoeing,0,2,0,2
LAT,Cycling,2,0,1,3
LAT,Gymnastics,1,1,0,2
LAT,Judo,0,0,1,1
LAT,Modern Pentathlon,0,1,0,1
LAT,Shooting,0,1,0,1
LAT,Weightlifting,0,1,2,3
LAT,Wrestling,0,1,0,1
LCA,Athletics,1,1,0,2
LIB,Weightlifting,0,1,0,1
LIB,Wrestling,0,1,2,3
LTU,3x3 Basketball,0,0,4,4
LTU,Athletics,3,2,1,6
LTU,Basketball,0,0,35,35
LTU,Boxing,0,0,1,1
LTU,Breaking,0,1,0,1
LTU,Canoeing,0,1,2,3
LTU,Cycling,0,0,1,1
LTU,Modern Pentathlon,1,3,1,5
LTU,Rowing,0,2,5,7
LTU,Sailing,0,1,0,1
LTU,Shooting,1,0,0,1
LTU,Swimming,1,0,0,1
LTU,Weightlifting,0,0,1,1
LTU,Wrestling,0,0,2,2
LUX,Art Competitions,2,1,0,3
LUX,Athletics,2,0,0,2
LUX,Weightlifting,0,1,0,1
MAR,Athletics,8,5,8,21
MAR,Boxing,0,0,4,4
MAR,Football,0,0,19,19
MAS,Badminton,0,9,8,17
MAS,Cycling,0,0,1,1
MAS,Cycling Track,0,1,0,1
MAS,Diving,0,2,1,3
MDA,Boxing,0,0,2,2
MDA,Canoe Sprint,0,0,2,2
MDA,Canoeing,0,2,0,2
MDA,Judo,0,0,2,2
MDA,Shooting,0,1,0,1
MDA,Weightlifting,0,0,2,2
MDA,Wrestling,0,1,1,2
MEX,Archery,0,1,6,7
MEX,Athletics,3,6,2,11
MEX,Basketball,0,0,11,11
MEX,Boxing,2,4,8,14
MEX,Cycling,0,1,1,2
MEX,Diving,1,11,10,22
MEX,Equestrianism,4,1,12,17
MEX,Fencing,0,1,0,1
MEX,Football,16,0,22,38
MEX,Judo,0,1,0,1
MEX,Modern Pentathlon,0,0,1,1
MEX,Polo,0,0,7,7
MEX,Shooting,0,1,0,1
MEX,Swimming,1,0,1,2
MEX,Taekwondo,2,2,3,7
MEX,Weightlifting,1,0,1,2
MEX,Wrestling,0,1,0,1
MGL,Boxing,1,2,4,7
MGL,Judo,1,5,6,12
MGL,Shooting,0,1,1,2
MGL,Wrestling,0,4,6,10
MKD,Taekwondo,0,1,0,1
MKD,Wrestling,0,0,1,1
MNE,Handball,0,14,0,14
MON,Art Competitions,0,0,1,1
MOZ,Athletics,1,0,1,2
MRI,Boxing,0,0,1,1
NAM,Athletics,0,5,0,5
NED,3x3 Basketball,4,0,0,4
NED,Archery,8,2,1,11
NED,Art Competitions,2,1,4,7
NED,Artistic Swimming,0,0,2,2
NED,Athletics,18,19,15,52
NED,Badminton,0,1,0,1
NED,Beach Volleyball,0,0,2,2
NED,Boxing,1,2,5,8
NED,Canoeing,0,4,8,12
NED,Cycling,25,25,17,67
NED,Cycling BMX Racing,1,1,1,3
NED,Cycling Road,1,3,1,5
NED,Cycling Track,12,2,4,18
NED,Equestrian,0,0,2,2
NED,Equestrianism,18,31,7,56
NED,Fencing,0,1,30,31
NED,Football,0,0,42,42
NED,Gymnastics,12,0,0,12
NED,Hockey,133,87,88,308
NED,Judo,4,2,18,24
NED,Marathon Swimming,1,1,0,2
NED,Rowing,36,74,70,180
NED,Sailing,15,20,17,52
NED,Shooting,0,1,5,6
NED,Swimming,30,50,38,118
NED,Tennis,0,2,2,4
NED,Tug-Of-War,0,8,0,8
NED,Volleyball,12,12,0,24
NED,Water Polo,12,0,32,44
NED,Weightlifting,0,0,3,3
NGR,Athletics,7,10,25,42
NGR,Boxing,0,3,3,6
NGR,Football,16,16,18,50
NGR,Taekwondo,0,0,1,1
NGR,Weightlifting,0,1,0,1
NGR,Wrestling,0,1,0,1
NIG,Boxing,0,0,1,1
NIG,Taekwondo,0,1,0,1
NOR,Art Competitions,0,1,0,1
NOR,Athletics,11,7,8,26
NOR,Beach Volleyball,2,0,2,4
NOR,Boxing,1,2,2,5
NOR,Canoeing,9,5,8,22
NOR,Cycling,2,0,2,4
NOR,Equestrianism,0,3,0,3
NOR,Fencing,0,1,0,1
NOR,Figure Skating,0,3,1,4
NOR,Football,17,0,30,47
NOR,Gymnastics,44,55,22,121
NOR,Handball,43,28,44,115
NOR,Rowing,4,19,39,62
NOR,Sailing,81,37,9,127
NOR,Shooting,29,33,15,77
NOR,Swimming,0,1,1,2
NOR,Taekwondo,0,2,0,2
NOR,Tennis,0,0,1,1
NOR,Triathlon,1,0,0,1
NOR,Weightlifting,2,0,0,2
NOR,Wrestling,4,2,3,9
NZL,Athletics,11,4,13,28
NZL,Boxing,1,1,2,4
NZL,Canoe Slalom,1,0,0,1
NZL,Canoe Sprint,11,0,0,11
NZL,Canoeing,12,4,2,18
NZL,Cycling,1,5,12,18
NZL,Cycling Track,2,11,1,14
NZL,Equestrianism,3,5,15,23
NZL,Golf,1,1,1,3
NZL,Hockey,14,0,0,14
NZL,Rowing,45,24,34,103
NZL,Rugby Sevens,25,25,0,50
NZL,Sailing,14,17,8,39
NZL,Shooting,0,1,1,2
NZL,Swimming,2,1,3,6
NZL,Tennis,0,0,2,2
NZL,Trampoline Gymnastics,0,0,1,1
NZL,Triathlon,1,2,2,5
NZL,Water Polo,1,0,0,1
PAK,Athletics,1,0,0,1
PAK,Boxing,0,0,1,1
PAK,Hockey,42,45,32,119
PAK,Wrestling,0,0,1,1
PAN,Athletics,1,0,2,3
PAN,Boxing,0,1,0,1
PAR,Football,0,17,0,17
PER,Sailing,0,0,1,1
PER,Shooting,1,2,0,3
PER,Volleyball,0,12,0,12
PHI,Artistic Gymnastics,2,0,0,2
PHI,Athletics,0,0,2,2
PHI,Boxing,0,4,6,10
PHI,Swimming,0,0,2,2
PHI,Weightlifting,1,1,0,2
POL,Archery,0,1,3,4
POL,Art Competitions,3,2,3,8
POL,Athletics,41,34,21,96
POL,Boxing,8,10,26,44
POL,Canoe Slalom,0,1,0,1
POL,Canoe Sprint,0,2,4,6
POL,Canoeing,0,13,24,37
POL,Cycling,0,19,5,24
POL,Cycling Track,0,1,0,1
POL,Equestrianism,1,10,4,15
POL,Fencing,8,36,42,86
POL,Football,17,33,0,50
POL,Gymnastics,1,1,7,9
POL,Handball,0,0,14,14
POL,Judo,3,3,2,8
POL,Modern Pentathlon,5,0,1,6
POL,Rowing,10,13,37,60
POL,Sailing,1,2,3,6
POL,Shooting,4,3,5,12
POL,Sport Climbing,1,0,1,2
POL,Swimming,1,3,2,6
POL,Tennis,0,0,1,1
POL,Volleyball,12,13,22,47
POL,Weightlifting,5,6,21,32
POL,Wrestling,5,9,13,27
POR,Athletics,5,4,4,13
POR,Canoe Sprint,0,0,1,1
POR,Canoeing,0,2,0,2
POR,Cycling,0,1,0,1
POR,Cycling Track,2,1,0,3
POR,Equestrianism,0,0,10,10
POR,Fencing,0,0,6,6
POR,Judo,0,0,4,4
POR,Sailing,0,4,4,8
POR,Shooting,0,1,0,1
POR,Triathlon,0,1,0,1
PRK,Boxing,2,3,4,9
PRK,Diving,0,2,1,3
PRK,Gymnastics,3,0,0,3
PRK,Judo,2,2,4,8
PRK,Shooting,1,0,2,3
PRK,Table Tennis,0,3,4,7
PRK,Volleyball,0,0,11,11
PRK,Weightlifting,5,7,5,17
PRK,Wrestling,3,2,7,12
PUR,Athletics,1,0,2,3
PUR,Boxing,0,1,5,6
PUR,Tennis,1,0,0,1
PUR,Wrestling,0,1,1,2
QAT,Athletics,1,1,3,5
QAT,Beach Volleyball,0,0,2,2
QAT,Shooting,0,0,1,1
QAT,Weightlifting,1,0,1,2
ROC,3x3 Basketball,0,8,0,8
ROC,Archery,0,4,0,4
ROC,Artistic Gymnastics,8,2,4,14
ROC,Artistic Swimming,10,0,0,10
ROC,Athletics,1,1,0,2
ROC,Beach Volleyball,0,2,0,2
ROC,Boxing,1,1,4,6
ROC,Cycling Track,0,0,5,5
ROC,Diving,0,0,2,2
ROC,Fencing,9,10,1,20
ROC,Handball,0,15,0,15
ROC,Judo,0,0,3,3
ROC,Rhythmic Gymnastics,0,6,0,6
ROC,Rowing,0,3,0,3
ROC,Shooting,2,5,3,10
ROC,Swimming,2,7,1,10
ROC,Taekwondo,2,1,1,4
ROC,Tennis,2,3,0,5
ROC,Volleyball,0,12,0,12
ROC,Wrestling,4,0,4,8
ROU,Artistic Gymnastics,0,0,1,1
ROU,Athletics,11,14,10,35
ROU,Boxing,1,9,15,25
ROU,Canoeing,18,24,25,67
ROU,Equestrianism,0,1,3,4
ROU,Fencing,7,15,26,48
ROU,Gymnastics,40,40,55,135
ROU,Handball,0,14,44,58
ROU,Judo,1,2,3,6
ROU,Rhythmic Gymnastics,0,1,0,1
ROU,Rowing,78,70,52,200
ROU,Rugby,0,0,16,16
ROU,Shooting,6,4,5,15
ROU,Swimming,4,2,5,11
ROU,Tennis,0,2,0,2
ROU,Volleyball,0,0,10,10
ROU,Weightlifting,2,8,4,14
ROU,Wrestling,7,8,18,33
RSA,Art Competitions,0,1,1,2
RSA,Athletics,8,22,6,36
RSA,Boxing,6,4,9,19
RSA,Canoeing,0,0,1,1
RSA,Cycling,1,9,6,16
RSA,Cycling Mountain Bike,0,0,1,1
RSA,Rowing,4,2,2,8
RSA,Rugby Sevens,0,0,26,26
RSA,Shooting,0,5,0,5
RSA,Surfing,0,1,0,1
RSA,Swimming,11,8,12,31
RSA,Tennis,4,3,1,8
RSA,Triathlon,0,0,1,1
RUS,Archery,0,3,1,4
RUS,Athletics,29,45,29,103
RUS,Badminton,0,0,2,2
RUS,Basketball,0,0,36,36
RUS,Boxing,10,5,15,30
RUS,Canoeing,3,5,14,22
RUS,Cycling,5,9,10,24
RUS,Diving,6,14,7,27
RUS,Fencing,33,10,19,62
RUS,Figure Skating,1,0,0,1
RUS,Gymnastics,16,38,29,83
RUS,Handball,30,14,14,58
RUS,Judo,5,4,7,16
RUS,Modern Pentathlon,4,1,0,5
RUS,Rhythmic Gymnastics,34,4,7,45
RUS,Rowing,4,0,14,18
RUS,Sailing,0,3,8,11
RUS,Shooting,7,17,12,36
RUS,Swimming,5,24,14,43
RUS,Synchronized Swimming,54,0,0,54
RUS,Taekwondo,0,2,2,4
RUS,Tennis,4,3,3,10
RUS,Trampolining,2,2,0,4
RUS,Volleyball,12,34,24,70
RUS,Water Polo,0,12,39,51
RUS,Weightlifting,3,13,10,26
RUS,Wrestling,29,16,15,60
SCG,Basketball,0,12,0,12
SCG,Shooting,1,2,1,4
SCG,Volleyball,11,0,12,23
SCG,Water Polo,0,12,13,25
SEN,Athletics,0,1,0,1
SGP,Sailing,0,0,1,1
SGP,Swimming,1,0,0,1
SGP,Table Tennis,0,3,4,7
SGP,Weightlifting,0,1,0,1
SLO,Athletics,1,2,1,4
SLO,Canoe Slalom,1,0,0,1
SLO,Canoeing,0,2,0,2
SLO,Cycling Road,1,0,1,2
SLO,Judo,3,1,3,7
SLO,Rowing,2,2,8,12
SLO,Sailing,0,3,1,4
SLO,Shooting,1,0,2,3
SLO,Sport Climbing,2,0,0,2
SLO,Swimming,0,1,0,1
SMR,Shooting,0,2,1,3
SMR,Wrestling,0,0,1,1
SRB,3x3 Basketball,0,0,4,4
SRB,Athletics,0,0,1,1
SRB,Basketball,0,12,24,36
SRB,Canoeing,0,2,0,2
SRB,Karate,1,0,0,1
SRB,Shooting,2,2,2,6
SRB,Swimming,0,1,0,1
SRB,Taekwondo,2,2,1,5
SRB,Tennis,1,0,1,2
SRB,Volleyball,0,12,12,24
SRB,Water Polo,39,0,26,65
SRB,Wrestling,1,0,1,2
SRI,Athletics,0,2,0,2
SUD,Athletics,0,1,0,1
SUI,Aeronautics,1,0,0,1
SUI,Alpinism,2,0,0,2
SUI,Art Competitions,3,5,1,9
SUI,Athletics,0,6,2,8
SUI,Beach Volleyball,0,0,6,6
SUI,Canoeing,0,4,0,4
SUI,Cycling,5,15,6,26
SUI,Cycling BMX Freestyle,0,0,1,1
SUI,Cycling BMX Racing,0,0,1,1
SUI,Cycling Mountain Bike,1,2,1,4
SUI,Cycling Road,0,1,0,1
SUI,Equestrian,0,1,0,1
SUI,Equestrianism,5,30,15,50
SUI,Fencing,1,10,12,23
SUI,Football,0,15,0,15
SUI,Gymnastics,23,40,21,84
SUI,Handball,0,0,17,17
SUI,Judo,1,1,2,4
SUI,Rowing,24,27,26,77
SUI,Sailing,3,6,3,12
SUI,Shooting,24,9,24,57
SUI,Swimming,0,0,4,4
SUI,Tennis,4,5,0,9
SUI,Triathlon,2,2,2,6
SUI,Weightlifting,0,2,2,4
SUI,Wrestling,4,4,7,15
SUR,Swimming,1,0,1,2
SVK,Athletics,1,0,0,1
SVK,Canoe Slalom,0,1,1,2
SVK,Canoe Sprint,0,0,4,4
SVK,Canoeing,12,12,8,32
SVK,Golf,0,1,0,1
SVK,Judo,0,1,0,1
SVK,Shooting,1,2,3,6
SVK,Swimming,0,2,0,2
SVK,Wrestling,0,0,1,1
SWE,Archery,0,2,0,2
SWE,Art Competitions,2,0,2,4
SWE,Athletics,35,36,61,132
SWE,Beach Volleyball,2,0,0,2
SWE,Boxing,0,5,6,11
SWE,Canoeing,23,23,11,57
SWE,Cycling,15,11,22,48
SWE,Cycling Mountain Bike,0,0,1,1
SWE,Diving,6,8,7,21
SWE,Equestrian,4,1,0,5
SWE,Equestrianism,37,24,24,85
SWE,Fencing,6,13,7,26
SWE,Figure Skating,3,2,1,6
SWE,Football,12,40,30,82
SWE,Golf,0,1,0,1
SWE,Gymnastics,95,7,1,103
SWE,Handball,0,61,0,61
SWE,Judo,0,0,1,1
SWE,Modern Pentathlon,9,9,7,25
SWE,Rowing,0,10,0,10
SWE,Sailing,33,50,37,120
SWE,Shooting,32,55,40,127
SWE,Swimming,11,27,35,73
SWE,Table Tennis,1,5,1,7
SWE,Tennis,0,6,8,14
SWE,Triathlon,0,1,0,1
SWE,Tug-Of-War,11,0,8,19
SWE,Water Polo,0,7,17,24
SWE,Weightlifting,0,0,4,4
SWE,Wrestling,28,27,31,86
SYR,Athletics,1,0,0,1
SYR,Boxing,0,0,1,1
SYR,Weightlifting,0,0,1,1
SYR,Wrestling,0,1,0,1
TAN,Athletics,0,2,0,2
TCH,Art Competitions,0,1,2,3
TCH,Athletics,11,8,5,24
TCH,Boxing,3,1,2,6
TCH,Canoeing,10,7,1,18
TCH,Cycling,2,3,8,13
TCH,Diving,1,1,0,2
TCH,Equestrianism,1,0,0,1
TCH,Football,16,17,0,33
TCH,Gymnastics,19,42,17,78
TCH,Handball,0,16,0,16
TCH,Hockey,0,16,0,16
TCH,Ice Hockey,0,0,8,8
TCH,Judo,0,0,1,1
TCH,Modern Pentathlon,0,3,1,4
TCH,Rowing,7,4,34,45
TCH,Shooting,4,3,2,9
TCH,Tennis,1,2,4,7
TCH,Volleyball,0,11,12,23
TCH,Weightlifting,3,2,3,8
TCH,Wrestling,1,7,7,15
TGA,Boxing,0,1,0,1
THA,Badminton,0,1,0,1
THA,Boxing,4,4,8,16
THA,Taekwondo,2,2,3,7
THA,Weightlifting,5,4,5,14
TJK,Athletics,1,0,0,1
TJK,Boxing,0,0,2,2
TJK,Judo,0,0,3,3
TJK,Wrestling,0,1,0,1
TKM,Weightlifting,0,1,0,1
TOG,Canoeing,0,0,1,1
TPE,Archery,0,6,6,12
TPE,Artistic Gymnastics,0,1,1,2
TPE,Athletics,0,1,1,2
TPE,Badminton,4,1,0,5
TPE,Baseball,0,20,0,20
TPE,Boxing,1,0,3,4
TPE,Golf,0,0,1,1
TPE,Judo,0,1,0,1
TPE,Karate,0,0,1,1
TPE,Shooting,0,0,1,1
TPE,Table Tennis,0,1,3,4
TPE,Taekwondo,2,1,6,9
TPE,Weightlifting,2,2,7,11
TTO,Athletics,7,7,14,28
TTO,Swimming,0,0,1,1
TTO,Weightlifting,0,1,2,3
TUN,Athletics,1,3,1,5
TUN,Boxing,0,0,2,2
TUN,Fencing,0,1,1,2
TUN,Swimming,3,0,1,4
TUN,Taekwondo,1,1,2,4
TUN,Wrestling,0,0,1,1
TUR,Archery,1,0,3,4
TUR,Artistic Gymnastics,0,0,1,1
TUR,Athletics,1,2,3,6
TUR,Boxing,1,5,4,10
TUR,Judo,1,0,1,2
TUR,Karate,0,1,3,4
TUR,Shooting,0,2,0,2
TUR,Taekwondo,1,3,6,10
TUR,Weightlifting,8,2,2,12
TUR,Wrestling,29,18,21,68
UAE,Judo,0,0,1,1
UAE,Shooting,1,0,0,1
UAR,Boxing,0,0,1,1
UAR,Wrestling,0,1,0,1
UGA,Athletics,5,2,2,9
UGA,Boxing,0,3,1,4
UKR,Archery,1,3,4,8
UKR,Artistic Gymnastics,0,1,0,1
UKR,Artistic Swimming,0,0,10,10
UKR,Athletics,3,3,19,25
UKR,Boxing,5,4,7,16
UKR,Canoe Sprint,0,4,1,5
UKR,Canoeing,3,2,7,12
UKR,Cycling,0,4,2,6
UKR,Cycling Track,0,1,0,1
UKR,Diving,0,0,4,4
UKR,Fencing,9,4,5,18
UKR,Gymnastics,5,8,10,23
UKR,Handball,0,0,15,15
UKR,Judo,0,1,3,4
UKR,Karate,0,1,1,2
UKR,Modern Pentathlon,0,1,1,2
UKR,Rhythmic Gymnastics,1,0,4,5
UKR,Rowing,4,4,4,12
UKR,Sailing,2,5,4,11
UKR,Shooting,4,3,4,11
UKR,Swimming,4,3,2,9
UKR,Tennis,0,0,1,1
UKR,Trampolining,1,1,0,2
UKR,Weightlifting,3,2,3,8
UKR,Wrestling,4,9,9,22
URS,Archery,1,3,3,7
URS,Athletics,83,70,89,242
URS,Basketball,48,50,48,146
URS,Boxing,14,19,18,51
URS,Canoeing,54,21,12,87
URS,Cycling,29,8,16,53
URS,Diving,4,4,6,14
URS,Equestrianism,16,7,6,29
URS,Fencing,63,47,36,146
URS,Football,36,0,51,87
URS,Gymnastics,141,99,48,288
URS,Handball,55,14,15,84
URS,Hockey,0,0,32,32
URS,Judo,5,5,13,23
URS,Modern Pentathlon,13,9,5,27
URS,Rhythmic Gymnastics,1,0,1,2
URS,Rowing,23,87,45,155
URS,Sailing,7,9,4,20
URS,Shooting,17,15,17,49
URS,Swimming,18,46,60,124
URS,Volleyball,81,48,12,141
URS,Water Polo,22,22,34,78
URS,Weightlifting,39,21,2,62
URS,Wrestling,62,31,23,116
URU,Basketball,0,0,24,24
URU,Boxing,0,0,1,1
URU,Cycling,0,1,0,1
URU,Football,31,0,0,31
URU,Rowing,0,1,5,6
USA,3x3 Basketball,4,0,4,8
USA,Archery,22,20,18,60
USA,Art Competitions,4,5,0,9
USA,Artistic Gymnastics,9,6,11,26
USA,Artistic Swimming,0,9,0,9
USA,Athletics,596,350,244,1190
USA,Baseball,24,0,44,68
USA,Baseball/Softball,0,39,0,39
USA,Basketball,329,24,36,389
USA,Beach Volleyball,14,4,4,22
USA,Boxing,50,27,41,118
USA,Breaking,0,0,1,1
USA,Canoe Slalom,0,0,1,1
USA,Canoe Sprint,1,1,0,2
USA,Canoeing,8,7,6,21
USA,Cycling,16,31,31,78
USA,Cycling BMX Freestyle,0,2,0,2
USA,Cycling Mountain Bike,0,1,0,1
USA,Cycling Track,6,0,5,11
USA,Diving,48,52,47,147
USA,Equestrian,0,11,0,11
USA,Equestrianism,30,49,53,132
USA,Fencing,10,19,52,81
USA,Figure Skating,0,0,1,1
USA,Football,86,24,34,144
USA,Golf,15,12,14,41
USA,Gymnastics,60,71,63,194
USA,Hockey,0,0,30,30
USA,Ice Hockey,0,11,0,11
USA,Jeu De Paume,1,0,0,1
USA,Judo,2,4,8,14
USA,Karate,0,0,1,1
USA,Lacrosse,0,12,0,12
USA,Modern Pentathlon,0,12,5,17
USA,Polo,2,5,5,12
USA,Roque,1,1,1,3
USA,Rowing,190,101,97,388
USA,Rugby,36,0,0,36
USA,Rugby Sevens,0,0,12,12
USA,Sailing,60,45,37,142
USA,Shooting,121,43,43,207
USA,Skateboarding,0,2,3,5
USA,Softball,45,15,0,60
USA,Sport Climbing,0,2,1,3
USA,Surfing,2,0,0,2
USA,Swimming,698,311,197,1206
USA,Synchronized Swimming,16,3,11,30
USA,Taekwondo,3,2,6,11
USA,Tennis,34,12,20,66
USA,Triathlon,1,5,2,8
USA,Tug-Of-War,5,5,4,14
USA,Volleyball,48,49,61,158
USA,Water Polo,45,72,59,176
USA,Weightlifting,17,17,12,46
USA,Wrestling,57,46,41,144
UZB,Boxing,10,2,8,20
UZB,Gymnastics,0,0,1,1
UZB,Judo,1,2,7,10
UZB,Taekwondo,2,1,0,3
UZB,Trampolining,0,0,1,1
UZB,Weightlifting,2,1,0,3
UZB,Wrestling,5,3,5,13
VEN,Athletics,1,1,1,3
VEN,Boxing,1,2,3,6
VEN,Cycling,0,0,1,1
VEN,Cycling BMX Freestyle,0,1,0,1
VEN,Fencing,1,0,0,1
VEN,Shooting,0,0,1,1
VEN,Swimming,0,0,1,1
VEN,Taekwondo,0,0,2,2
VEN,Weightlifting,0,2,1,3
VIE,Shooting,1,1,0,2
VIE,Taekwondo,0,1,0,1
VIE,Weightlifting,0,1,0,1
WIF,Athletics,0,0,5,5
YUG,Athletics,0,2,0,2
YUG,Basketball,12,48,24,84
YUG,Boxing,3,2,6,11
YUG,Canoeing,3,3,1,7
YUG,Football,16,40,17,73
YUG,Gymnastics,5,2,11,18
YUG,Handball,43,14,15,72
YUG,Judo,0,0,2,2
YUG,Rowing,4,2,7,13
YUG,Shooting,2,0,1,3
YUG,Swimming,1,1,0,2
YUG,Table Tennis,0,2,2,4
YUG,Water Polo,37,39,0,76
YUG,Wrestling,4,6,6,16
ZAM,Athletics,0,1,1,2
ZAM,Boxing,0,0,1,1
ZIM,Hockey,15,0,0,15
ZIM,Swimming,2,4,1,7
