,NOC,Sport,Year,Gold,Silver,Bronze,Total
0,AFG,Taekwondo,2008,0,0,1,1
1,AFG,Taekwondo,2012,0,0,1,1
2,AHO,Sailing,1988,0,1,0,1
3,AIN,Rowing,2024,0,1,0,1
4,AIN,Tennis,2024,0,2,0,2
5,AIN,Trampoline Gymnastics,2024,1,1,0,2
6,AIN,Weightlifting,2024,0,0,1,1
7,ALB,Wrestling,2024,0,0,2,2
8,ALG,Boxing,1984,0,0,2,2
9,ALG,Boxing,1992,0,0,1,1
10,ALG,Athletics,1992,1,0,0,1
11,ALG,Boxing,1996,1,0,1,2
12,ALG,Athletics,1996,1,0,0,1
13,ALG,Boxing,2000,0,0,1,1
14,ALG,Athletics,2000,1,1,2,4
15,ALG,Judo,2008,0,1,1,2
16,ALG,Athletics,2012,1,0,0,1
17,ALG,Athletics,2016,0,2,0,2
18,ALG,Boxing,2024,1,0,0,1
19,ALG,Athletics,2024,0,0,1,1
20,ALG,Artistic Gymnastics,2024,1,0,0,1
21,ANZ,Boxing,1908,0,1,0,1
22,ANZ,Athletics,1908,0,0,1,1
23,ANZ,Rugby,1908,15,0,0,15
24,ANZ,Swimming,1908,0,1,1,2
25,ANZ,Tennis,1912,0,0,1,1
26,ANZ,Swimming,1912,5,2,2,9
27,ARG,Boxing,1924,0,2,2,4
28,ARG,Athletics,1924,0,1,0,1
29,ARG,Polo,1924,5,0,0,5
30,ARG,Boxing,1928,2,2,0,4
31,ARG,Swimming,1928,1,0,0,1
32,ARG,Fencing,1928,0,0,5,5
33,ARG,Football,1928,0,16,0,16
34,ARG,Boxing,1932,2,1,0,3
35,ARG,Athletics,1932,1,0,0,1
36,ARG,Rowing,1936,0,0,2,2
37,ARG,Boxing,1936,1,1,2,4
38,ARG,Swimming,1936,0,1,0,1
39,ARG,Polo,1936,4,0,0,4
40,ARG,Sailing,1948,0,5,0,5
41,ARG,Boxing,1948,2,0,1,3
42,ARG,Athletics,1948,1,1,0,2
43,ARG,Shooting,1948,0,1,0,1
44,ARG,Rowing,1952,2,0,0,2
45,ARG,Weightlifting,1952,0,0,1,1
46,ARG,Boxing,1952,0,1,1,2
47,ARG,Athletics,1952,0,1,0,1
48,ARG,Weightlifting,1956,0,1,0,1
49,ARG,Boxing,1956,0,0,1,1
50,ARG,Sailing,1960,0,3,0,3
51,ARG,Boxing,1960,0,0,1,1
52,ARG,Equestrianism,1964,0,1,0,1
53,ARG,Rowing,1968,0,0,1,1
54,ARG,Boxing,1968,0,0,1,1
55,ARG,Rowing,1972,0,1,0,1
56,ARG,Tennis,1988,0,1,0,1
57,ARG,Volleyball,1988,0,0,12,12
58,ARG,Tennis,1992,0,0,2,2
59,ARG,Sailing,1996,0,1,0,1
60,ARG,Boxing,1996,0,0,1,1
61,ARG,Football,1996,0,18,0,18
62,ARG,Sailing,2000,0,1,3,4
63,ARG,Hockey,2000,0,16,0,16
64,ARG,Sailing,2004,0,0,2,2
65,ARG,Tennis,2004,0,0,2,2
66,ARG,Swimming,2004,0,0,1,1
67,ARG,Football,2004,16,0,0,16
68,ARG,Hockey,2004,0,0,16,16
69,ARG,Basketball,2004,12,0,0,12
70,ARG,Sailing,2008,0,0,2,2
71,ARG,Judo,2008,0,0,1,1
72,ARG,Football,2008,18,0,0,18
73,ARG,Hockey,2008,0,0,16,16
74,ARG,Basketball,2008,0,0,12,12
75,ARG,Cycling,2008,2,0,0,2
76,ARG,Taekwondo,2012,1,0,0,1
77,ARG,Sailing,2012,0,0,2,2
78,ARG,Tennis,2012,0,0,1,1
79,ARG,Hockey,2012,0,15,0,15
80,ARG,Sailing,2016,2,0,0,2
81,ARG,Tennis,2016,0,1,0,1
82,ARG,Judo,2016,1,0,0,1
83,ARG,Hockey,2016,18,0,0,18
84,ARG,Volleyball,2020,0,0,12,12
85,ARG,Hockey,2020,0,18,0,18
86,ARG,Rugby Sevens,2020,0,0,13,13
87,ARG,Sailing,2024,0,2,0,2
88,ARG,Hockey,2024,0,0,16,16
89,ARG,Cycling BMX Freestyle,2024,1,0,0,1
90,ARM,Wrestling,1996,1,1,0,2
91,ARM,Weightlifting,2000,0,0,1,1
92,ARM,Weightlifting,2008,0,0,3,3
93,ARM,Wrestling,2008,0,0,2,2
94,ARM,Boxing,2008,0,0,1,1
95,ARM,Weightlifting,2012,0,0,1,1
96,ARM,Wrestling,2012,0,1,1,2
97,ARM,Weightlifting,2016,0,2,0,2
98,ARM,Wrestling,2016,1,1,0,2
99,ARM,Weightlifting,2020,0,1,0,1
100,ARM,Wrestling,2020,0,1,0,1
101,ARM,Boxing,2020,0,0,1,1
102,ARM,Artistic Gymnastics,2020,0,0,1,1
103,ARM,Weightlifting,2024,0,1,0,1
104,ARM,Wrestling,2024,0,1,1,2
105,ARM,Artistic Gymnastics,2024,0,1,0,1
106,AUS,Tennis,1896,0,0,1,1
107,AUS,Athletics,1896,2,0,0,2
108,AUS,Athletics,1900,1,0,3,4
109,AUS,Swimming,1900,2,0,0,2
110,AUS,Swimming,1904,0,3,1,4
111,AUS,Athletics,1906,0,0,2,2
112,AUS,Swimming,1906,0,0,1,1
113,AUS,Athletics,1920,0,1,0,1
114,AUS,Swimming,1920,0,5,1,6
115,AUS,Athletics,1924,1,0,0,1
116,AUS,Swimming,1924,1,5,2,8
117,AUS,Diving,1924,1,0,0,1
118,AUS,Rowing,1928,1,0,0,1
119,AUS,Swimming,1928,0,2,0,2
120,AUS,Cycling,1928,0,0,1,1
121,AUS,Rowing,1932,1,0,0,1
122,AUS,Wrestling,1932,0,0,1,1
123,AUS,Swimming,1932,1,1,0,2
124,AUS,Cycling,1932,1,0,0,1
125,AUS,Athletics,1936,0,0,1,1
126,AUS,Rowing,1948,1,0,0,1
127,AUS,Wrestling,1948,0,1,1,2
128,AUS,Athletics,1948,1,6,2,9
129,AUS,Swimming,1948,0,2,2,4
130,AUS,Rowing,1952,0,1,9,10
131,AUS,Weightlifting,1952,0,0,1,1
132,AUS,Athletics,1952,3,0,1,4
133,AUS,Swimming,1952,1,0,0,1
134,AUS,Cycling,1952,3,1,0,4
135,AUS,Sailing,1956,0,2,3,5
136,AUS,Rowing,1956,0,1,11,12
137,AUS,Boxing,1956,0,0,1,1
138,AUS,Athletics,1956,7,6,6,19
139,AUS,Swimming,1956,19,4,2,25
140,AUS,Cycling,1956,2,0,1,3
141,AUS,Canoeing,1956,0,0,2,2
142,AUS,Boxing,1960,0,0,2,2
143,AUS,Athletics,1960,1,2,1,4
144,AUS,Swimming,1960,5,21,8,34
145,AUS,Equestrianism,1960,5,1,0,6
146,AUS,Sailing,1964,3,0,0,3
147,AUS,Athletics,1964,1,1,4,6
148,AUS,Judo,1964,0,0,1,1
149,AUS,Swimming,1964,4,5,11,20
150,AUS,Hockey,1964,0,0,14,14
151,AUS,Rowing,1968,0,9,0,9
152,AUS,Athletics,1968,2,3,1,6
153,AUS,Swimming,1968,3,9,6,18
154,AUS,Equestrianism,1968,0,0,4,4
155,AUS,Hockey,1968,0,14,0,14
156,AUS,Sailing,1972,5,0,0,5
157,AUS,Athletics,1972,0,2,0,2
158,AUS,Swimming,1972,6,2,2,10
159,AUS,Cycling,1972,0,3,0,3
160,AUS,Sailing,1976,0,0,3,3
161,AUS,Swimming,1976,0,0,1,1
162,AUS,Equestrianism,1976,0,0,4,4
163,AUS,Hockey,1976,0,15,0,15
164,AUS,Athletics,1980,0,1,0,1
165,AUS,Swimming,1980,6,0,5,11
166,AUS,Canoeing,1980,0,1,0,1
167,AUS,Sailing,1984,0,0,2,2
168,AUS,Rowing,1984,0,4,14,18
169,AUS,Weightlifting,1984,1,1,0,2
170,AUS,Athletics,1984,1,1,1,3
171,AUS,Swimming,1984,1,8,11,20
172,AUS,Shooting,1984,0,0,1,1
173,AUS,Cycling,1984,4,0,0,4
174,AUS,Canoeing,1984,0,0,2,2
175,AUS,Tennis,1988,0,0,2,2
176,AUS,Boxing,1988,0,1,0,1
177,AUS,Athletics,1988,1,1,0,2
178,AUS,Swimming,1988,1,1,1,3
179,AUS,Hockey,1988,16,0,0,16
180,AUS,Cycling,1988,0,2,6,8
181,AUS,Canoeing,1988,0,1,2,3
182,AUS,Sailing,1992,0,0,3,3
183,AUS,Rowing,1992,6,0,0,6
184,AUS,Tennis,1992,0,0,2,2
185,AUS,Athletics,1992,0,0,2,2
186,AUS,Swimming,1992,1,3,5,9
187,AUS,Equestrianism,1992,5,0,0,5
188,AUS,Hockey,1992,0,16,0,16
189,AUS,Cycling,1992,1,7,0,8
190,AUS,Canoeing,1992,1,1,4,6
191,AUS,Sailing,1996,0,2,2,4
192,AUS,Rowing,1996,6,2,8,16
193,AUS,Tennis,1996,2,0,0,2
194,AUS,Weightlifting,1996,0,0,1,1
195,AUS,Athletics,1996,0,2,0,2
196,AUS,Swimming,1996,2,9,14,25
197,AUS,Shooting,1996,2,0,1,3
198,AUS,Equestrianism,1996,4,0,0,4
199,AUS,Hockey,1996,16,0,16,32
200,AUS,Basketball,1996,0,0,12,12
201,AUS,Cycling,1996,0,1,8,9
202,AUS,Canoeing,1996,0,0,5,5
203,AUS,Beach Volleyball,1996,0,0,2,2
204,AUS,Softball,1996,0,0,15,15
205,AUS,Taekwondo,2000,1,1,0,2
206,AUS,Sailing,2000,4,2,1,7
207,AUS,Rowing,2000,0,15,6,21
208,AUS,Tennis,2000,0,2,0,2
209,AUS,Athletics,2000,1,2,0,3
210,AUS,Judo,2000,0,0,1,1
211,AUS,Swimming,2000,15,27,4,46
212,AUS,Shooting,2000,1,1,1,3
213,AUS,Equestrianism,2000,4,1,0,5
214,AUS,Hockey,2000,16,0,16,32
215,AUS,Basketball,2000,0,12,0,12
216,AUS,Cycling,2000,2,2,5,9
217,AUS,Diving,2000,0,0,4,4
218,AUS,Canoeing,2000,0,2,1,3
219,AUS,Beach Volleyball,2000,2,0,0,2
220,AUS,Softball,2000,0,0,15,15
221,AUS,Archery,2000,1,0,0,1
222,AUS,Trampolining,2000,0,1,0,1
223,AUS,Triathlon,2000,0,1,0,1
224,AUS,Water Polo,2000,13,0,0,13
225,AUS,Rowing,2004,2,4,13,19
226,AUS,Tennis,2004,0,0,1,1
227,AUS,Athletics,2004,0,4,2,6
228,AUS,Swimming,2004,17,11,3,31
229,AUS,Shooting,2004,1,0,1,2
230,AUS,Hockey,2004,16,0,0,16
231,AUS,Basketball,2004,0,12,0,12
232,AUS,Cycling,2004,12,2,3,17
233,AUS,Diving,2004,1,1,7,9
234,AUS,Canoeing,2004,0,3,0,3
235,AUS,Softball,2004,0,15,0,15
236,AUS,Archery,2004,0,0,1,1
237,AUS,Triathlon,2004,0,1,0,1
238,AUS,Baseball,2004,0,24,0,24
239,AUS,Sailing,2008,4,2,0,6
240,AUS,Rowing,2008,4,4,0,8
241,AUS,Athletics,2008,1,2,1,4
242,AUS,Swimming,2008,19,13,22,54
243,AUS,Shooting,2008,0,0,1,1
244,AUS,Equestrianism,2008,0,5,0,5
245,AUS,Hockey,2008,0,0,17,17
246,AUS,Basketball,2008,0,12,0,12
247,AUS,Cycling,2008,0,1,0,1
248,AUS,Diving,2008,1,2,0,3
249,AUS,Canoeing,2008,1,1,6,8
250,AUS,Softball,2008,0,0,15,15
251,AUS,Triathlon,2008,1,0,1,2
252,AUS,Water Polo,2008,0,0,13,13
253,AUS,Sailing,2012,5,3,0,8
254,AUS,Rowing,2012,0,8,5,13
255,AUS,Athletics,2012,1,2,0,3
256,AUS,Swimming,2012,7,17,8,32
257,AUS,Hockey,2012,0,0,16,16
258,AUS,Basketball,2012,0,0,12,12
259,AUS,Cycling,2012,1,5,4,10
260,AUS,Diving,2012,0,1,0,1
261,AUS,Canoeing,2012,4,1,0,5
262,AUS,Triathlon,2012,0,0,1,1
263,AUS,Water Polo,2012,0,0,13,13
264,AUS,Sailing,2016,1,6,0,7
265,AUS,Rowing,2016,1,8,0,9
266,AUS,Athletics,2016,0,1,1,2
267,AUS,Swimming,2016,7,14,11,32
268,AUS,Shooting,2016,1,0,0,1
269,AUS,Equestrianism,2016,0,0,4,4
270,AUS,Cycling,2016,0,5,1,6
271,AUS,Rugby Sevens,2016,12,0,0,12
272,AUS,Diving,2016,0,0,2,2
273,AUS,Canoeing,2016,0,0,3,3
274,AUS,Archery,2016,0,0,3,3
275,AUS,Modern Pentathlon,2016,1,0,0,1
276,AUS,Sailing,2020,3,0,0,3
277,AUS,Rowing,2020,8,0,8,16
278,AUS,Tennis,2020,0,0,2,2
279,AUS,Boxing,2020,0,0,1,1
280,AUS,Athletics,2020,0,1,2,3
281,AUS,Swimming,2020,20,3,30,53
282,AUS,Hockey,2020,0,18,0,18
283,AUS,Basketball,2020,0,0,12,12
284,AUS,Cycling BMX Freestyle,2020,1,0,0,1
285,AUS,Diving,2020,0,0,1,1
286,AUS,Beach Volleyball,2020,0,2,0,2
287,AUS,Canoe Slalom,2020,1,0,1,2
288,AUS,Canoe Sprint,2020,2,0,0,2
289,AUS,Cycling Road,2020,0,0,1,1
290,AUS,Cycling Track,2020,0,0,6,6
291,AUS,Equestrian,2020,0,4,1,5
292,AUS,Marathon Swimming,2020,0,0,1,1
293,AUS,Skateboarding,2020,1,0,0,1
294,AUS,Surfing,2020,0,0,1,1
295,AUS,Sailing,2024,1,1,0,2
296,AUS,Rowing,2024,0,0,2,2
297,AUS,Tennis,2024,2,0,0,2
298,AUS,Boxing,2024,0,0,2,2
299,AUS,Athletics,2024,1,2,5,8
300,AUS,Swimming,2024,17,19,15,51
301,AUS,Shooting,2024,0,0,1,1
302,AUS,Basketball,2024,0,0,11,11
303,AUS,Cycling BMX Freestyle,2024,0,0,1,1
304,AUS,Diving,2024,0,1,0,1
305,AUS,Water Polo,2024,0,13,0,13
306,AUS,Canoe Slalom,2024,3,0,0,3
307,AUS,Canoe Sprint,2024,0,4,2,6
308,AUS,Cycling Road,2024,1,0,0,1
309,AUS,Cycling Track,2024,5,2,5,12
310,AUS,Equestrian,2024,0,1,0,1
311,AUS,Skateboarding,2024,2,0,0,2
312,AUS,Surfing,2024,0,1,0,1
313,AUS,Cycling BMX Racing,2024,1,0,0,1
314,AUT,Swimming,1896,1,1,0,2
315,AUT,Cycling,1896,1,0,2,3
316,AUT,Swimming,1900,0,3,1,4
317,AUT,Fencing,1900,0,0,2,2
318,AUT,Swimming,1904,0,0,1,1
319,AUT,Gymnastics,1904,2,1,0,3
320,AUT,Weightlifting,1906,1,1,0,2
321,AUT,Wrestling,1906,1,2,1,4
322,AUT,Swimming,1906,1,0,1,2
323,AUT,Diving,1906,0,0,1,1
324,AUT,Swimming,1908,0,0,1,1
325,AUT,Tennis,1912,0,2,0,2
326,AUT,Swimming,1912,0,0,4,4
327,AUT,Fencing,1912,0,7,1,8
328,AUT,Weightlifting,1924,0,3,1,4
329,AUT,Rowing,1928,0,0,2,2
330,AUT,Weightlifting,1928,2,0,0,2
331,AUT,Art Competitions,1928,1,0,0,1
332,AUT,Weightlifting,1932,0,1,1,2
333,AUT,Wrestling,1932,0,0,2,2
334,AUT,Fencing,1932,1,0,0,1
335,AUT,Rowing,1936,0,1,0,1
336,AUT,Weightlifting,1936,1,0,0,1
337,AUT,Fencing,1936,0,0,1,1
338,AUT,Football,1936,0,13,0,13
339,AUT,Equestrianism,1936,0,0,1,1
340,AUT,Canoeing,1936,4,5,2,11
341,AUT,Art Competitions,1936,1,1,3,5
342,AUT,Handball,1936,0,22,0,22
343,AUT,Athletics,1948,1,0,1,2
344,AUT,Fencing,1948,0,0,1,1
345,AUT,Canoeing,1948,0,0,1,1
346,AUT,Art Competitions,1948,1,2,1,4
347,AUT,Canoeing,1952,0,1,2,3
348,AUT,Rowing,1956,0,0,2,2
349,AUT,Canoeing,1956,0,0,2,2
350,AUT,Rowing,1960,0,2,0,2
351,AUT,Shooting,1960,1,0,0,1
352,AUT,Sailing,1968,0,1,0,1
353,AUT,Athletics,1968,0,1,1,2
354,AUT,Canoeing,1968,0,0,2,2
355,AUT,Athletics,1972,0,0,1,1
356,AUT,Shooting,1972,0,0,1,1
357,AUT,Canoeing,1972,0,1,0,1
358,AUT,Shooting,1976,0,0,1,1
359,AUT,Sailing,1980,0,3,0,3
360,AUT,Shooting,1980,0,0,1,1
361,AUT,Equestrianism,1980,1,0,0,1
362,AUT,Judo,1984,1,0,1,2
363,AUT,Shooting,1984,0,1,0,1
364,AUT,Judo,1988,1,0,0,1
365,AUT,Rowing,1992,0,2,0,2
366,AUT,Equestrianism,1992,0,4,0,4
367,AUT,Athletics,1996,0,0,1,1
368,AUT,Shooting,1996,0,1,1,2
369,AUT,Sailing,2000,3,0,0,3
370,AUT,Athletics,2000,0,1,0,1
371,AUT,Sailing,2004,2,1,0,3
372,AUT,Judo,2004,0,1,0,1
373,AUT,Swimming,2004,0,2,0,2
374,AUT,Shooting,2004,0,0,1,1
375,AUT,Triathlon,2004,1,0,0,1
376,AUT,Judo,2008,0,1,0,1
377,AUT,Swimming,2008,0,0,1,1
378,AUT,Canoeing,2008,0,0,1,1
379,AUT,Sailing,2016,0,0,2,2
380,AUT,Rowing,2020,0,0,1,1
381,AUT,Athletics,2020,0,0,1,1
382,AUT,Judo,2020,0,1,1,2
383,AUT,Cycling Road,2020,1,0,0,1
384,AUT,Karate,2020,0,0,1,1
385,AUT,Sport Climbing,2020,0,0,1,1
386,AUT,Sailing,2024,3,0,0,3
387,AUT,Judo,2024,0,0,1,1
388,AUT,Sport Climbing,2024,0,0,2,2
389,AZE,Wrestling,1996,0,1,0,1
390,AZE,Wrestling,2000,1,0,0,1
391,AZE,Boxing,2000,0,0,1,1
392,AZE,Shooting,2000,1,0,0,1
393,AZE,Wrestling,2004,1,0,0,1
394,AZE,Boxing,2004,0,0,2,2
395,AZE,Shooting,2004,0,0,2,2
396,AZE,Wrestling,2008,0,2,2,4
397,AZE,Boxing,2008,0,0,1,1
398,AZE,Judo,2008,1,0,1,2
399,AZE,Weightlifting,2012,0,0,1,1
400,AZE,Wrestling,2012,2,2,3,7
401,AZE,Boxing,2012,0,0,2,2
402,AZE,Taekwondo,2016,1,0,2,3
403,AZE,Wrestling,2016,0,3,6,9
404,AZE,Boxing,2016,0,1,1,2
405,AZE,Judo,2016,0,2,0,2
406,AZE,Canoeing,2016,0,1,1,2
407,AZE,Wrestling,2020,0,1,2,3
408,AZE,Boxing,2020,0,0,1,1
409,AZE,Judo,2020,0,0,1,1
410,AZE,Karate,2020,0,2,0,2
411,AZE,Taekwondo,2024,0,1,0,1
412,AZE,Wrestling,2024,0,0,3,3
413,AZE,Boxing,2024,0,1,0,1
414,AZE,Judo,2024,2,0,0,2
415,BAH,Sailing,1956,0,0,2,2
416,BAH,Sailing,1964,2,0,0,2
417,BAH,Athletics,1992,0,0,1,1
418,BAH,Athletics,1996,0,5,0,5
419,BAH,Athletics,2000,6,0,5,11
420,BAH,Athletics,2004,1,0,1,2
421,BAH,Athletics,2008,0,6,1,7
422,BAH,Athletics,2012,4,0,0,4
423,BAH,Athletics,2016,1,0,5,6
424,BAH,Athletics,2020,2,0,0,2
425,BAR,Athletics,2000,0,0,1,1
426,BDI,Athletics,1996,1,0,0,1
427,BDI,Athletics,2016,0,1,0,1
428,BEL,Rowing,1900,0,9,0,9
429,BEL,Football,1900,0,0,9,9
430,BEL,Shooting,1900,0,1,2,3
431,BEL,Equestrianism,1900,3,1,1,5
432,BEL,Archery,1900,3,3,1,7
433,BEL,Water Polo,1900,0,10,0,10
434,BEL,Rowing,1906,0,2,0,2
435,BEL,Wrestling,1906,0,0,1,1
436,BEL,Athletics,1906,0,1,0,1
437,BEL,Fencing,1906,2,0,4,6
438,BEL,Cycling,1906,0,0,1,1
439,BEL,Sailing,1908,0,3,0,3
440,BEL,Rowing,1908,0,9,0,9
441,BEL,Fencing,1908,0,0,7,7
442,BEL,Shooting,1908,1,5,0,6
443,BEL,Cycling,1908,0,0,1,1
444,BEL,Water Polo,1908,0,7,0,7
445,BEL,Rowing,1912,0,1,0,1
446,BEL,Fencing,1912,7,0,1,8
447,BEL,Equestrianism,1912,0,0,1,1
448,BEL,Water Polo,1912,0,0,9,9
449,BEL,Sailing,1920,3,3,5,11
450,BEL,Weightlifting,1920,1,1,1,3
451,BEL,Swimming,1920,0,0,1,1
452,BEL,Fencing,1920,0,7,0,7
453,BEL,Football,1920,14,0,0,14
454,BEL,Shooting,1920,0,6,0,6
455,BEL,Equestrianism,1920,4,4,4,12
456,BEL,Hockey,1920,0,0,14,14
457,BEL,Cycling,1920,1,0,4,5
458,BEL,Archery,1920,32,11,2,45
459,BEL,Water Polo,1920,0,8,0,8
460,BEL,Gymnastics,1920,0,24,24,48
461,BEL,Art Competitions,1920,2,1,3,6
462,BEL,Tug-Of-War,1920,0,0,8,8
463,BEL,Sailing,1924,1,0,0,1
464,BEL,Wrestling,1924,0,1,0,1
465,BEL,Boxing,1924,1,0,1,2
466,BEL,Swimming,1924,0,1,0,1
467,BEL,Fencing,1924,1,12,1,14
468,BEL,Cycling,1924,0,5,4,9
469,BEL,Water Polo,1924,0,11,0,11
470,BEL,Rowing,1928,0,0,3,3
471,BEL,Wrestling,1928,0,1,0,1
472,BEL,Boxing,1928,0,0,1,1
473,BEL,Art Competitions,1932,0,0,1,1
474,BEL,Cycling,1936,0,0,4,4
475,BEL,Water Polo,1936,0,0,9,9
476,BEL,Art Competitions,1936,0,0,1,1
477,BEL,Boxing,1948,0,1,0,1
478,BEL,Athletics,1948,1,0,1,2
479,BEL,Fencing,1948,0,0,6,6
480,BEL,Cycling,1948,4,1,1,6
481,BEL,Rowing,1952,0,2,0,2
482,BEL,Cycling,1952,5,1,0,6
483,BEL,Sailing,1956,0,1,0,1
484,BEL,Wrestling,1956,0,1,0,1
485,BEL,Sailing,1960,0,0,1,1
486,BEL,Athletics,1960,0,1,0,1
487,BEL,Cycling,1960,0,1,1,2
488,BEL,Athletics,1964,1,0,0,1
489,BEL,Cycling,1964,1,0,1,2
490,BEL,Weightlifting,1968,0,1,0,1
491,BEL,Cycling,1968,0,0,2,2
492,BEL,Athletics,1972,0,2,0,2
493,BEL,Athletics,1976,0,2,1,3
494,BEL,Equestrianism,1976,0,0,5,5
495,BEL,Cycling,1976,0,1,0,1
496,BEL,Judo,1980,1,0,0,1
497,BEL,Rowing,1984,0,2,1,3
498,BEL,Swimming,1984,0,0,1,1
499,BEL,Cycling,1984,1,0,0,1
500,BEL,Judo,1988,0,0,1,1
501,BEL,Shooting,1988,0,0,1,1
502,BEL,Rowing,1992,0,1,0,1
503,BEL,Judo,1992,0,0,1,1
504,BEL,Cycling,1992,0,0,1,1
505,BEL,Sailing,1996,0,1,0,1
506,BEL,Judo,1996,1,1,2,4
507,BEL,Swimming,1996,1,0,0,1
508,BEL,Tennis,2000,0,0,2,2
509,BEL,Judo,2000,0,0,2,2
510,BEL,Cycling,2000,0,3,0,3
511,BEL,Tennis,2004,1,0,0,1
512,BEL,Judo,2004,0,0,1,1
513,BEL,Cycling,2004,0,0,1,1
514,BEL,Athletics,2008,1,4,0,5
515,BEL,Sailing,2012,0,0,1,1
516,BEL,Judo,2012,0,0,1,1
517,BEL,Shooting,2012,0,1,0,1
518,BEL,Athletics,2016,1,0,0,1
519,BEL,Judo,2016,0,0,1,1
520,BEL,Swimming,2016,0,1,0,1
521,BEL,Hockey,2016,0,16,0,16
522,BEL,Cycling,2016,1,0,1,2
523,BEL,Athletics,2020,1,0,1,2
524,BEL,Judo,2020,0,0,1,1
525,BEL,Artistic Gymnastics,2020,1,0,0,1
526,BEL,Hockey,2020,18,0,0,18
527,BEL,Cycling Road,2020,0,1,0,1
528,BEL,Equestrian,2020,0,0,4,4
529,BEL,Taekwondo,2024,0,0,1,1
530,BEL,Athletics,2024,1,1,1,3
531,BEL,Judo,2024,0,0,1,1
532,BEL,Cycling Road,2024,2,0,1,3
533,BEL,Cycling Track,2024,0,0,1,1
534,BER,Boxing,1976,0,0,1,1
535,BER,Triathlon,2020,1,0,0,1
536,BLR,Rowing,1996,1,0,9,10
537,BLR,Wrestling,1996,0,3,1,4
538,BLR,Athletics,1996,0,2,2,4
539,BLR,Shooting,1996,0,1,0,1
540,BLR,Gymnastics,1996,0,0,4,4
541,BLR,Rowing,2000,1,0,0,1
542,BLR,Weightlifting,2000,0,0,2,2
543,BLR,Wrestling,2000,0,0,1,1
544,BLR,Athletics,2000,2,0,3,5
545,BLR,Judo,2000,0,0,1,1
546,BLR,Shooting,2000,0,1,3,4
547,BLR,Modern Pentathlon,2000,0,0,1,1
548,BLR,Rhythmic Gymnastics,2000,0,7,0,7
549,BLR,Rowing,2004,0,1,2,3
550,BLR,Weightlifting,2004,0,2,1,3
551,BLR,Wrestling,2004,0,0,1,1
552,BLR,Boxing,2004,0,2,0,2
553,BLR,Athletics,2004,1,0,0,1
554,BLR,Judo,2004,1,0,0,1
555,BLR,Shooting,2004,0,0,1,1
556,BLR,Cycling,2004,0,0,1,1
557,BLR,Canoeing,2004,0,0,2,2
558,BLR,Rowing,2008,0,0,3,3
559,BLR,Weightlifting,2008,1,1,1,3
560,BLR,Wrestling,2008,0,0,2,2
561,BLR,Athletics,2008,1,3,2,6
562,BLR,Canoeing,2008,6,0,2,8
563,BLR,Rhythmic Gymnastics,2008,0,1,6,7
564,BLR,Tennis,2012,2,0,1,3
565,BLR,Weightlifting,2012,0,0,2,2
566,BLR,Swimming,2012,0,2,0,2
567,BLR,Shooting,2012,1,0,0,1
568,BLR,Canoeing,2012,0,4,4,8
569,BLR,Rhythmic Gymnastics,2012,0,6,1,7
570,BLR,Weightlifting,2016,0,2,0,2
571,BLR,Wrestling,2016,0,1,2,3
572,BLR,Athletics,2016,0,1,0,1
573,BLR,Swimming,2016,0,0,1,1
574,BLR,Canoeing,2016,0,0,4,4
575,BLR,Trampolining,2016,1,0,0,1
576,BLR,Trampoline Gymnastics,2020,1,0,0,1
577,BLR,Wrestling,2020,0,2,1,3
578,BLR,Athletics,2020,0,0,1,1
579,BLR,Canoe Sprint,2020,0,4,0,4
580,BLR,Rhythmic Gymnastics,2020,0,0,1,1
581,BOH,Tennis,1900,0,0,2,2
582,BOH,Athletics,1900,0,1,0,1
583,BOH,Tennis,1906,0,0,3,3
584,BOH,Fencing,1908,0,0,6,6
585,BOT,Athletics,2012,0,1,0,1
586,BOT,Athletics,2020,0,0,6,6
587,BOT,Athletics,2024,1,6,0,7
588,BRA,Shooting,1920,1,1,5,7
589,BRA,Basketball,1948,0,0,10,10
590,BRA,Athletics,1952,1,0,1,2
591,BRA,Swimming,1952,0,0,1,1
592,BRA,Athletics,1956,1,0,0,1
593,BRA,Swimming,1960,0,0,1,1
594,BRA,Basketball,1960,0,0,12,12
595,BRA,Basketball,1964,0,0,12,12
596,BRA,Sailing,1968,0,0,2,2
597,BRA,Boxing,1968,0,0,1,1
598,BRA,Athletics,1968,0,1,0,1
599,BRA,Athletics,1972,0,0,1,1
600,BRA,Judo,1972,0,0,1,1
601,BRA,Sailing,1976,0,0,2,2
602,BRA,Athletics,1976,0,0,1,1
603,BRA,Sailing,1980,4,0,0,4
604,BRA,Athletics,1980,0,0,1,1
605,BRA,Swimming,1980,0,0,4,4
606,BRA,Sailing,1984,0,3,0,3
607,BRA,Athletics,1984,1,0,0,1
608,BRA,Judo,1984,0,1,2,3
609,BRA,Swimming,1984,0,1,0,1
610,BRA,Football,1984,0,16,0,16
611,BRA,Volleyball,1984,0,12,0,12
612,BRA,Sailing,1988,0,0,4,4
613,BRA,Athletics,1988,0,1,1,2
614,BRA,Judo,1988,1,0,0,1
615,BRA,Football,1988,0,16,0,16
616,BRA,Judo,1992,1,0,0,1
617,BRA,Swimming,1992,0,1,0,1
618,BRA,Volleyball,1992,12,0,0,12
619,BRA,Sailing,1996,3,0,2,5
620,BRA,Athletics,1996,0,0,4,4
621,BRA,Judo,1996,0,0,2,2
622,BRA,Swimming,1996,0,1,2,3
623,BRA,Football,1996,0,0,17,17
624,BRA,Equestrianism,1996,0,0,4,4
625,BRA,Volleyball,1996,0,0,12,12
626,BRA,Basketball,1996,0,12,0,12
627,BRA,Beach Volleyball,1996,2,2,0,4
628,BRA,Sailing,2000,0,1,2,3
629,BRA,Athletics,2000,0,5,0,5
630,BRA,Judo,2000,0,2,0,2
631,BRA,Swimming,2000,0,0,4,4
632,BRA,Equestrianism,2000,0,0,4,4
633,BRA,Volleyball,2000,0,0,12,12
634,BRA,Basketball,2000,0,0,12,12
635,BRA,Beach Volleyball,2000,0,4,2,6
636,BRA,Sailing,2004,3,0,0,3
637,BRA,Athletics,2004,0,0,1,1
638,BRA,Judo,2004,0,0,2,2
639,BRA,Football,2004,0,17,0,17
640,BRA,Equestrianism,2004,1,0,0,1
641,BRA,Volleyball,2004,12,0,0,12
642,BRA,Beach Volleyball,2004,2,2,0,4
643,BRA,Taekwondo,2008,0,0,1,1
644,BRA,Sailing,2008,0,2,2,4
645,BRA,Athletics,2008,1,0,4,5
646,BRA,Judo,2008,0,0,3,3
647,BRA,Swimming,2008,1,0,1,2
648,BRA,Football,2008,0,18,17,35
649,BRA,Volleyball,2008,12,12,0,24
650,BRA,Beach Volleyball,2008,0,2,2,4
651,BRA,Sailing,2012,0,0,2,2
652,BRA,Boxing,2012,0,1,2,3
653,BRA,Judo,2012,1,0,3,4
654,BRA,Swimming,2012,0,1,1,2
655,BRA,Football,2012,0,18,0,18
656,BRA,Volleyball,2012,12,12,0,24
657,BRA,Beach Volleyball,2012,0,2,2,4
658,BRA,Modern Pentathlon,2012,0,0,1,1
659,BRA,Gymnastics,2012,1,0,0,1
660,BRA,Taekwondo,2016,0,0,1,1
661,BRA,Sailing,2016,2,0,0,2
662,BRA,Boxing,2016,1,0,0,1
663,BRA,Athletics,2016,1,0,0,1
664,BRA,Judo,2016,1,0,2,3
665,BRA,Swimming,2016,0,0,1,1
666,BRA,Football,2016,17,0,0,17
667,BRA,Shooting,2016,0,1,0,1
668,BRA,Volleyball,2016,12,0,0,12
669,BRA,Canoeing,2016,0,3,1,4
670,BRA,Beach Volleyball,2016,2,2,0,4
671,BRA,Gymnastics,2016,0,2,1,3
672,BRA,Sailing,2020,2,0,0,2
673,BRA,Tennis,2020,0,0,2,2
674,BRA,Boxing,2020,1,1,1,3
675,BRA,Athletics,2020,0,0,2,2
676,BRA,Judo,2020,0,0,2,2
677,BRA,Artistic Gymnastics,2020,1,1,0,2
678,BRA,Swimming,2020,0,0,2,2
679,BRA,Football,2020,22,0,0,22
680,BRA,Volleyball,2020,0,12,0,12
681,BRA,Canoe Sprint,2020,1,0,0,1
682,BRA,Marathon Swimming,2020,1,0,0,1
683,BRA,Skateboarding,2020,0,3,0,3
684,BRA,Surfing,2020,1,0,0,1
685,BRA,Taekwondo,2024,0,0,1,1
686,BRA,Boxing,2024,0,0,1,1
687,BRA,Athletics,2024,0,1,1,2
688,BRA,Judo,2024,1,1,11,13
689,BRA,Artistic Gymnastics,2024,1,2,5,8
690,BRA,Football,2024,0,22,0,22
691,BRA,Volleyball,2024,0,0,13,13
692,BRA,Beach Volleyball,2024,2,0,0,2
693,BRA,Canoe Sprint,2024,0,1,0,1
694,BRA,Skateboarding,2024,0,0,2,2
695,BRA,Surfing,2024,0,1,1,2
696,BRN,Athletics,2012,0,0,1,1
697,BRN,Athletics,2016,1,1,0,2
698,BRN,Athletics,2020,0,1,0,1
699,BRN,Weightlifting,2024,0,0,1,1
700,BRN,Wrestling,2024,1,0,0,1
701,BRN,Athletics,2024,1,1,0,2
702,BUL,Boxing,1952,0,0,1,1
703,BUL,Wrestling,1956,1,3,0,4
704,BUL,Football,1956,0,0,14,14
705,BUL,Wrestling,1960,1,3,2,6
706,BUL,Gymnastics,1960,0,0,1,1
707,BUL,Wrestling,1964,3,4,1,8
708,BUL,Boxing,1964,0,0,1,1
709,BUL,Shooting,1964,0,1,0,1
710,BUL,Wrestling,1968,2,3,1,6
711,BUL,Boxing,1968,0,0,2,2
712,BUL,Football,1968,0,18,0,18
713,BUL,Weightlifting,1972,3,3,0,6
714,BUL,Wrestling,1972,2,4,2,8
715,BUL,Boxing,1972,1,1,0,2
716,BUL,Athletics,1972,0,2,2,4
717,BUL,Canoeing,1972,0,0,2,2
718,BUL,Rowing,1976,4,5,0,9
719,BUL,Weightlifting,1976,2,3,1,6
720,BUL,Wrestling,1976,1,3,3,7
721,BUL,Boxing,1976,0,0,1,1
722,BUL,Athletics,1976,1,2,1,4
723,BUL,Basketball,1976,0,0,12,12
724,BUL,Rowing,1980,0,5,11,16
725,BUL,Weightlifting,1980,2,4,2,8
726,BUL,Wrestling,1980,3,4,3,10
727,BUL,Boxing,1980,1,0,1,2
728,BUL,Athletics,1980,0,1,1,2
729,BUL,Judo,1980,0,1,1,2
730,BUL,Shooting,1980,0,0,2,2
731,BUL,Equestrianism,1980,0,3,0,3
732,BUL,Volleyball,1980,0,12,10,22
733,BUL,Basketball,1980,0,12,0,12
734,BUL,Canoeing,1980,1,2,6,9
735,BUL,Gymnastics,1980,1,0,1,2
736,BUL,Rowing,1988,0,2,3,5
737,BUL,Tennis,1988,0,0,1,1
738,BUL,Weightlifting,1988,2,1,1,4
739,BUL,Wrestling,1988,1,4,3,8
740,BUL,Boxing,1988,1,1,0,2
741,BUL,Athletics,1988,2,1,1,4
742,BUL,Swimming,1988,1,1,1,3
743,BUL,Shooting,1988,1,1,0,2
744,BUL,Canoeing,1988,1,2,6,9
745,BUL,Gymnastics,1988,1,0,1,2
746,BUL,Rhythmic Gymnastics,1988,0,1,0,1
747,BUL,Weightlifting,1992,1,2,1,4
748,BUL,Wrestling,1992,0,1,1,2
749,BUL,Boxing,1992,0,1,1,2
750,BUL,Athletics,1992,0,1,1,2
751,BUL,Shooting,1992,0,2,1,3
752,BUL,Canoeing,1992,2,0,2,4
753,BUL,Weightlifting,1996,0,1,2,3
754,BUL,Wrestling,1996,1,0,0,1
755,BUL,Boxing,1996,1,2,0,3
756,BUL,Athletics,1996,1,0,0,1
757,BUL,Shooting,1996,0,2,2,4
758,BUL,Canoeing,1996,0,0,2,2
759,BUL,Gymnastics,1996,0,1,0,1
760,BUL,Rhythmic Gymnastics,1996,0,6,0,6
761,BUL,Rowing,2000,0,1,0,1
762,BUL,Weightlifting,2000,1,2,0,3
763,BUL,Wrestling,2000,1,1,0,2
764,BUL,Athletics,2000,1,0,0,1
765,BUL,Shooting,2000,2,0,0,2
766,BUL,Canoeing,2000,0,2,0,2
767,BUL,Gymnastics,2000,0,0,2,2
768,BUL,Rowing,2004,0,0,2,2
769,BUL,Weightlifting,2004,1,0,1,2
770,BUL,Wrestling,2004,0,0,1,1
771,BUL,Boxing,2004,0,0,1,1
772,BUL,Judo,2004,0,0,1,1
773,BUL,Shooting,2004,1,0,1,2
774,BUL,Gymnastics,2004,0,1,1,2
775,BUL,Rhythmic Gymnastics,2004,0,0,6,6
776,BUL,Rowing,2008,1,0,0,1
777,BUL,Wrestling,2008,0,1,3,4
778,BUL,Wrestling,2012,0,1,0,1
779,BUL,Boxing,2012,0,0,1,1
780,BUL,Wrestling,2016,0,0,1,1
781,BUL,Athletics,2016,0,1,0,1
782,BUL,Rhythmic Gymnastics,2016,0,0,5,5
783,BUL,Wrestling,2020,0,0,2,2
784,BUL,Boxing,2020,1,0,0,1
785,BUL,Shooting,2020,0,1,0,1
786,BUL,Karate,2020,1,0,0,1
787,BUL,Rhythmic Gymnastics,2020,5,0,0,5
788,BUL,Taekwondo,2024,0,0,1,1
789,BUL,Weightlifting,2024,1,0,1,2
790,BUL,Wrestling,2024,2,0,0,2
791,BUL,Boxing,2024,0,0,1,1
792,BUL,Rhythmic Gymnastics,2024,0,1,0,1
793,BUR,Athletics,2020,0,0,1,1
794,CAN,Athletics,1900,1,0,1,2
795,CAN,Rowing,1904,0,9,0,9
796,CAN,Athletics,1904,1,0,0,1
797,CAN,Football,1904,13,0,0,13
798,CAN,Golf,1904,1,0,0,1
799,CAN,Lacrosse,1904,12,0,12,24
800,CAN,Athletics,1906,1,1,0,2
801,CAN,Rowing,1908,0,0,15,15
802,CAN,Wrestling,1908,0,0,1,1
803,CAN,Athletics,1908,1,1,4,6
804,CAN,Shooting,1908,1,7,6,14
805,CAN,Cycling,1908,0,0,4,4
806,CAN,Lacrosse,1908,12,0,0,12
807,CAN,Rowing,1912,0,0,1,1
808,CAN,Athletics,1912,1,2,2,5
809,CAN,Swimming,1912,2,0,0,2
810,CAN,Boxing,1920,1,2,2,5
811,CAN,Athletics,1920,1,0,0,1
812,CAN,Swimming,1920,0,1,1,2
813,CAN,Ice Hockey,1920,8,0,0,8
814,CAN,Rowing,1924,0,13,0,13
815,CAN,Boxing,1924,0,0,1,1
816,CAN,Shooting,1924,0,6,0,6
817,CAN,Rowing,1928,0,2,9,11
818,CAN,Wrestling,1928,0,1,2,3
819,CAN,Boxing,1928,0,0,1,1
820,CAN,Athletics,1928,7,2,5,14
821,CAN,Swimming,1928,0,0,4,4
822,CAN,Sailing,1932,0,6,4,10
823,CAN,Rowing,1932,0,0,11,11
824,CAN,Wrestling,1932,0,1,0,1
825,CAN,Boxing,1932,1,0,0,1
826,CAN,Athletics,1932,1,6,8,15
827,CAN,Art Competitions,1932,0,0,1,1
828,CAN,Wrestling,1936,0,0,1,1
829,CAN,Athletics,1936,0,1,6,7
830,CAN,Basketball,1936,0,9,0,9
831,CAN,Canoeing,1936,1,2,2,5
832,CAN,Athletics,1948,0,0,4,4
833,CAN,Canoeing,1948,0,1,1,2
834,CAN,Art Competitions,1948,0,1,0,1
835,CAN,Weightlifting,1952,0,1,0,1
836,CAN,Shooting,1952,1,0,0,1
837,CAN,Canoeing,1952,0,2,0,2
838,CAN,Rowing,1956,4,9,0,13
839,CAN,Shooting,1956,1,0,1,2
840,CAN,Equestrianism,1956,0,0,3,3
841,CAN,Diving,1956,0,0,1,1
842,CAN,Rowing,1960,0,9,0,9
843,CAN,Rowing,1964,2,0,0,2
844,CAN,Athletics,1964,0,1,1,2
845,CAN,Judo,1964,0,1,0,1
846,CAN,Swimming,1968,0,3,4,7
847,CAN,Equestrianism,1968,3,0,0,3
848,CAN,Sailing,1972,0,0,3,3
849,CAN,Swimming,1972,0,2,6,8
850,CAN,Athletics,1976,0,1,0,1
851,CAN,Swimming,1976,0,6,14,20
852,CAN,Equestrianism,1976,0,1,0,1
853,CAN,Canoeing,1976,0,1,0,1
854,CAN,Sailing,1984,0,2,4,6
855,CAN,Rowing,1984,9,7,7,23
856,CAN,Weightlifting,1984,0,1,0,1
857,CAN,Wrestling,1984,0,1,1,2
858,CAN,Boxing,1984,0,2,1,3
859,CAN,Athletics,1984,0,9,6,15
860,CAN,Judo,1984,0,0,1,1
861,CAN,Swimming,1984,4,6,6,16
862,CAN,Shooting,1984,1,0,0,1
863,CAN,Cycling,1984,0,2,0,2
864,CAN,Diving,1984,1,0,0,1
865,CAN,Canoeing,1984,3,3,6,12
866,CAN,Rhythmic Gymnastics,1984,1,0,0,1
867,CAN,Synchronized Swimming,1984,0,3,0,3
868,CAN,Sailing,1988,0,0,2,2
869,CAN,Boxing,1988,1,1,1,3
870,CAN,Athletics,1988,0,0,1,1
871,CAN,Swimming,1988,0,4,6,10
872,CAN,Equestrianism,1988,0,0,4,4
873,CAN,Synchronized Swimming,1988,3,0,0,3
874,CAN,Sailing,1992,0,0,2,2
875,CAN,Rowing,1992,24,0,1,25
876,CAN,Wrestling,1992,0,1,0,1
877,CAN,Boxing,1992,0,1,1,2
878,CAN,Athletics,1992,1,1,1,3
879,CAN,Judo,1992,0,0,1,1
880,CAN,Swimming,1992,1,0,5,6
881,CAN,Cycling,1992,0,0,1,1
882,CAN,Synchronized Swimming,1992,1,2,0,3
883,CAN,Rowing,1996,2,15,4,21
884,CAN,Wrestling,1996,0,1,0,1
885,CAN,Boxing,1996,0,1,0,1
886,CAN,Athletics,1996,6,0,0,6
887,CAN,Swimming,1996,0,1,2,3
888,CAN,Cycling,1996,0,2,3,5
889,CAN,Diving,1996,0,0,1,1
890,CAN,Canoeing,1996,0,1,0,1
891,CAN,Beach Volleyball,1996,0,0,2,2
892,CAN,Synchronized Swimming,1996,0,9,0,9
893,CAN,Taekwondo,2000,0,0,1,1
894,CAN,Rowing,2000,0,0,9,9
895,CAN,Tennis,2000,2,0,0,2
896,CAN,Wrestling,2000,1,0,0,1
897,CAN,Judo,2000,0,1,0,1
898,CAN,Swimming,2000,0,0,1,1
899,CAN,Diving,2000,0,2,1,3
900,CAN,Canoeing,2000,0,1,1,2
901,CAN,Trampolining,2000,0,0,2,2
902,CAN,Triathlon,2000,1,0,0,1
903,CAN,Synchronized Swimming,2000,0,0,8,8
904,CAN,Sailing,2004,0,2,0,2
905,CAN,Rowing,2004,0,4,0,4
906,CAN,Wrestling,2004,0,1,0,1
907,CAN,Cycling,2004,1,1,0,2
908,CAN,Diving,2004,0,1,2,3
909,CAN,Canoeing,2004,1,0,2,3
910,CAN,Trampolining,2004,0,1,0,1
911,CAN,Gymnastics,2004,1,0,0,1
912,CAN,Taekwondo,2008,0,1,0,1
913,CAN,Rowing,2008,9,2,6,17
914,CAN,Wrestling,2008,1,0,1,2
915,CAN,Athletics,2008,0,0,2,2
916,CAN,Swimming,2008,0,0,1,1
917,CAN,Equestrianism,2008,1,4,0,5
918,CAN,Diving,2008,0,2,0,2
919,CAN,Canoeing,2008,0,1,1,2
920,CAN,Trampolining,2008,0,2,0,2
921,CAN,Triathlon,2008,0,1,0,1
922,CAN,Rowing,2012,0,18,0,18
923,CAN,Weightlifting,2012,0,0,1,1
924,CAN,Wrestling,2012,0,1,1,2
925,CAN,Athletics,2012,0,0,1,1
926,CAN,Judo,2012,0,0,1,1
927,CAN,Swimming,2012,0,1,2,3
928,CAN,Football,2012,0,0,18,18
929,CAN,Cycling,2012,0,0,3,3
930,CAN,Diving,2012,0,0,4,4
931,CAN,Canoeing,2012,0,1,2,3
932,CAN,Trampolining,2012,1,0,0,1
933,CAN,Rowing,2016,0,2,0,2
934,CAN,Wrestling,2016,1,0,0,1
935,CAN,Athletics,2016,1,1,8,10
936,CAN,Swimming,2016,1,1,13,15
937,CAN,Football,2016,0,0,18,18
938,CAN,Equestrianism,2016,0,0,1,1
939,CAN,Cycling,2016,0,0,6,6
940,CAN,Rugby Sevens,2016,0,0,12,12
941,CAN,Diving,2016,0,0,3,3
942,CAN,Trampolining,2016,1,0,0,1
943,CAN,Rowing,2020,9,0,2,11
944,CAN,Weightlifting,2020,1,0,0,1
945,CAN,Athletics,2020,2,1,9,12
946,CAN,Judo,2020,0,0,2,2
947,CAN,Swimming,2020,1,7,7,15
948,CAN,Football,2020,22,0,0,22
949,CAN,Diving,2020,0,2,0,2
950,CAN,Canoe Sprint,2020,0,1,2,3
951,CAN,Cycling Track,2020,1,0,1,2
952,CAN,Baseball/Softball,2020,0,0,15,15
953,CAN,Taekwondo,2024,0,0,1,1
954,CAN,Rowing,2024,0,9,0,9
955,CAN,Tennis,2024,0,0,2,2
956,CAN,Trampoline Gymnastics,2024,0,0,1,1
957,CAN,Weightlifting,2024,0,1,0,1
958,CAN,Boxing,2024,0,0,1,1
959,CAN,Athletics,2024,8,1,1,10
960,CAN,Judo,2024,1,0,0,1
961,CAN,Swimming,2024,3,2,3,8
962,CAN,Fencing,2024,0,0,1,1
963,CAN,Rugby Sevens,2024,0,14,0,14
964,CAN,Diving,2024,0,0,2,2
965,CAN,Beach Volleyball,2024,0,2,0,2
966,CAN,Canoe Sprint,2024,1,0,2,3
967,CAN,Breaking,2024,1,0,0,1
968,CHI,Athletics,1928,0,1,0,1
969,CHI,Equestrianism,1952,0,4,0,4
970,CHI,Boxing,1956,0,1,2,3
971,CHI,Athletics,1956,0,1,0,1
972,CHI,Shooting,1988,0,1,0,1
973,CHI,Football,2000,0,0,17,17
974,CHI,Tennis,2004,3,0,1,4
975,CHI,Tennis,2008,0,1,0,1
976,CHI,Wrestling,2024,0,1,0,1
977,CHI,Shooting,2024,1,0,0,1
978,CHN,Weightlifting,1984,4,2,0,6
979,CHN,Athletics,1984,0,0,1,1
980,CHN,Fencing,1984,1,0,0,1
981,CHN,Shooting,1984,3,0,3,6
982,CHN,Volleyball,1984,10,0,0,10
983,CHN,Basketball,1984,0,0,12,12
984,CHN,Diving,1984,1,1,1,3
985,CHN,Archery,1984,0,1,0,1
986,CHN,Gymnastics,1984,5,9,7,21
987,CHN,Handball,1984,0,0,13,13
988,CHN,Rowing,1988,0,5,9,14
989,CHN,Weightlifting,1988,0,1,4,5
990,CHN,Athletics,1988,0,0,1,1
991,CHN,Swimming,1988,0,3,1,4
992,CHN,Shooting,1988,0,1,1,2
993,CHN,Volleyball,1988,0,0,11,11
994,CHN,Diving,1988,2,3,1,6
995,CHN,Gymnastics,1988,1,0,1,2
996,CHN,Table Tennis,1988,3,3,1,7
997,CHN,Sailing,1992,0,1,0,1
998,CHN,Rowing,1992,0,0,2,2
999,CHN,Weightlifting,1992,0,2,2,4
1000,CHN,Wrestling,1992,0,0,1,1
1001,CHN,Athletics,1992,1,1,2,4
1002,CHN,Judo,1992,1,0,2,3
1003,CHN,Swimming,1992,4,9,0,13
1004,CHN,Fencing,1992,0,1,0,1
1005,CHN,Shooting,1992,2,2,0,4
1006,CHN,Basketball,1992,0,11,0,11
1007,CHN,Diving,1992,3,1,1,5
1008,CHN,Archery,1992,0,3,0,3
1009,CHN,Gymnastics,1992,2,9,2,13
1010,CHN,Table Tennis,1992,5,3,1,9
1011,CHN,Badminton,1992,0,2,6,8
1012,CHN,Rowing,1996,0,2,0,2
1013,CHN,Weightlifting,1996,2,1,1,4
1014,CHN,Wrestling,1996,0,0,1,1
1015,CHN,Athletics,1996,1,2,1,4
1016,CHN,Judo,1996,1,0,1,2
1017,CHN,Swimming,1996,1,6,5,12
1018,CHN,Football,1996,0,15,0,15
1019,CHN,Shooting,1996,2,2,1,5
1020,CHN,Volleyball,1996,0,9,0,9
1021,CHN,Diving,1996,3,1,1,5
1022,CHN,Softball,1996,0,15,0,15
1023,CHN,Archery,1996,0,1,0,1
1024,CHN,Gymnastics,1996,1,10,1,12
1025,CHN,Table Tennis,1996,6,5,1,12
1026,CHN,Badminton,1996,2,1,4,7
1027,CHN,Taekwondo,2000,1,0,0,1
1028,CHN,Weightlifting,2000,5,1,1,7
1029,CHN,Wrestling,2000,0,0,1,1
1030,CHN,Athletics,2000,1,0,0,1
1031,CHN,Judo,2000,2,1,1,4
1032,CHN,Fencing,2000,0,3,3,6
1033,CHN,Shooting,2000,3,2,3,8
1034,CHN,Cycling,2000,0,0,1,1
1035,CHN,Diving,2000,7,7,0,14
1036,CHN,Gymnastics,2000,8,2,2,12
1037,CHN,Table Tennis,2000,6,5,1,12
1038,CHN,Badminton,2000,6,2,4,12
1039,CHN,Taekwondo,2004,2,0,0,2
1040,CHN,Sailing,2004,0,1,0,1
1041,CHN,Tennis,2004,2,0,0,2
1042,CHN,Weightlifting,2004,5,3,0,8
1043,CHN,Wrestling,2004,1,0,0,1
1044,CHN,Boxing,2004,0,0,1,1
1045,CHN,Athletics,2004,2,0,0,2
1046,CHN,Judo,2004,1,1,3,5
1047,CHN,Swimming,2004,1,5,0,6
1048,CHN,Fencing,2004,0,6,0,6
1049,CHN,Shooting,2004,4,2,3,9
1050,CHN,Volleyball,2004,12,0,0,12
1051,CHN,Cycling,2004,0,1,0,1
1052,CHN,Diving,2004,9,2,1,12
1053,CHN,Canoeing,2004,2,0,0,2
1054,CHN,Archery,2004,0,3,0,3
1055,CHN,Trampolining,2004,0,0,1,1
1056,CHN,Gymnastics,2004,1,0,2,3
1057,CHN,Table Tennis,2004,5,1,3,9
1058,CHN,Badminton,2004,5,2,1,8
1059,CHN,Taekwondo,2008,1,0,1,2
1060,CHN,Sailing,2008,1,0,1,2
1061,CHN,Rowing,2008,4,2,0,6
1062,CHN,Tennis,2008,0,0,2,2
1063,CHN,Weightlifting,2008,8,1,0,9
1064,CHN,Wrestling,2008,1,2,0,3
1065,CHN,Boxing,2008,2,1,1,4
1066,CHN,Athletics,2008,0,0,2,2
1067,CHN,Judo,2008,3,0,1,4
1068,CHN,Swimming,2008,1,7,6,14
1069,CHN,Fencing,2008,1,4,0,5
1070,CHN,Shooting,2008,5,2,1,8
1071,CHN,Volleyball,2008,0,0,12,12
1072,CHN,Hockey,2008,0,16,0,16
1073,CHN,Cycling,2008,0,0,1,1
1074,CHN,Diving,2008,11,1,3,15
1075,CHN,Canoeing,2008,2,0,0,2
1076,CHN,Beach Volleyball,2008,0,2,2,4
1077,CHN,Archery,2008,1,3,3,7
1078,CHN,Trampolining,2008,2,0,1,3
1079,CHN,Gymnastics,2008,19,1,4,24
1080,CHN,Rhythmic Gymnastics,2008,0,6,0,6
1081,CHN,Synchronized Swimming,2008,0,0,9,9
1082,CHN,Table Tennis,2008,8,2,2,12
1083,CHN,Badminton,2008,4,3,5,12
1084,CHN,Taekwondo,2012,1,1,1,3
1085,CHN,Sailing,2012,1,0,0,1
1086,CHN,Rowing,2012,0,2,0,2
1087,CHN,Weightlifting,2012,5,2,0,7
1088,CHN,Wrestling,2012,0,1,0,1
1089,CHN,Boxing,2012,1,1,1,3
1090,CHN,Athletics,2012,1,0,5,6
1091,CHN,Judo,2012,0,1,1,2
1092,CHN,Swimming,2012,5,2,8,15
1093,CHN,Fencing,2012,5,0,1,6
1094,CHN,Shooting,2012,2,2,3,7
1095,CHN,Cycling,2012,0,3,1,4
1096,CHN,Diving,2012,10,3,1,14
1097,CHN,Archery,2012,0,3,1,4
1098,CHN,Trampolining,2012,1,1,2,4
1099,CHN,Modern Pentathlon,2012,0,1,0,1
1100,CHN,Gymnastics,2012,8,3,1,12
1101,CHN,Synchronized Swimming,2012,0,9,2,11
1102,CHN,Table Tennis,2012,8,2,0,10
1103,CHN,Badminton,2012,8,3,1,12
1104,CHN,Taekwondo,2016,2,0,0,2
1105,CHN,Sailing,2016,0,1,0,1
1106,CHN,Rowing,2016,0,0,3,3
1107,CHN,Weightlifting,2016,5,2,0,7
1108,CHN,Wrestling,2016,0,0,2,2
1109,CHN,Boxing,2016,0,1,3,4
1110,CHN,Athletics,2016,2,2,2,6
1111,CHN,Judo,2016,0,0,2,2
1112,CHN,Swimming,2016,1,2,3,6
1113,CHN,Fencing,2016,0,4,1,5
1114,CHN,Shooting,2016,1,2,4,7
1115,CHN,Volleyball,2016,12,0,0,12
1116,CHN,Cycling,2016,2,0,0,2
1117,CHN,Diving,2016,10,2,2,14
1118,CHN,Trampolining,2016,0,1,2,3
1119,CHN,Gymnastics,2016,0,0,10,10
1120,CHN,Golf,2016,0,0,1,1
1121,CHN,Synchronized Swimming,2016,0,11,0,11
1122,CHN,Table Tennis,2016,8,2,0,10
1123,CHN,Badminton,2016,3,0,2,5
1124,CHN,Taekwondo,2020,0,0,1,1
1125,CHN,Sailing,2020,1,0,1,2
1126,CHN,Rowing,2020,4,0,11,15
1127,CHN,Trampoline Gymnastics,2020,1,2,0,3
1128,CHN,Weightlifting,2020,7,1,0,8
1129,CHN,Wrestling,2020,0,2,2,4
1130,CHN,Boxing,2020,0,2,0,2
1131,CHN,Athletics,2020,2,2,1,5
1132,CHN,Artistic Gymnastics,2020,3,3,5,11
1133,CHN,Swimming,2020,8,5,1,14
1134,CHN,Fencing,2020,1,0,0,1
1135,CHN,Shooting,2020,6,1,6,13
1136,CHN,Diving,2020,10,6,0,16
1137,CHN,Canoe Sprint,2020,2,3,0,5
1138,CHN,Cycling Track,2020,3,0,0,3
1139,CHN,Karate,2020,0,1,1,2
1140,CHN,Table Tennis,2020,8,4,0,12
1141,CHN,Badminton,2020,3,7,0,10
1142,CHN,3x3 Basketball,2020,0,0,4,4
1143,CHN,Artistic Swimming,2020,0,10,0,10
1144,CHN,Taekwondo,2024,0,1,1,2
1145,CHN,Tennis,2024,1,2,0,3
1146,CHN,Trampoline Gymnastics,2024,0,1,1,2
1147,CHN,Weightlifting,2024,5,0,0,5
1148,CHN,Wrestling,2024,0,1,4,5
1149,CHN,Boxing,2024,3,2,0,5
1150,CHN,Athletics,2024,1,1,2,4
1151,CHN,Judo,2024,0,0,1,1
1152,CHN,Artistic Gymnastics,2024,2,9,2,13
1153,CHN,Swimming,2024,6,8,22,36
1154,CHN,Shooting,2024,6,2,4,12
1155,CHN,Hockey,2024,0,17,0,17
1156,CHN,Cycling BMX Freestyle,2024,1,0,0,1
1157,CHN,Diving,2024,12,2,1,15
1158,CHN,Archery,2024,0,3,0,3
1159,CHN,Canoe Sprint,2024,4,0,0,4
1160,CHN,Sport Climbing,2024,0,2,0,2
1161,CHN,Rhythmic Gymnastics,2024,5,0,0,5
1162,CHN,Golf,2024,0,0,1,1
1163,CHN,Breaking,2024,0,0,1,1
1164,CHN,Table Tennis,2024,10,1,0,11
1165,CHN,Badminton,2024,4,5,0,9
1166,CHN,Artistic Swimming,2024,11,0,0,11
1167,CIV,Athletics,1984,0,1,0,1
1168,CIV,Taekwondo,2016,1,0,1,2
1169,CIV,Taekwondo,2020,0,0,1,1
1170,CIV,Taekwondo,2024,0,0,1,1
1171,CMR,Boxing,1968,0,1,0,1
1172,CMR,Boxing,1984,0,0,1,1
1173,CMR,Football,2000,18,0,0,18
1174,CMR,Athletics,2004,1,0,0,1
1175,CMR,Athletics,2008,1,0,0,1
1176,COL,Tug-Of-War,1900,0,1,0,1
1177,COL,Boxing,1972,0,0,2,2
1178,COL,Shooting,1972,0,1,0,1
1179,COL,Shooting,1984,0,1,0,1
1180,COL,Boxing,1988,0,0,1,1
1181,COL,Athletics,1992,0,0,1,1
1182,COL,Weightlifting,2000,1,0,0,1
1183,COL,Weightlifting,2004,0,0,1,1
1184,COL,Cycling,2004,0,0,1,1
1185,COL,Weightlifting,2008,0,1,0,1
1186,COL,Wrestling,2008,0,0,1,1
1187,COL,Taekwondo,2012,0,0,1,1
1188,COL,Weightlifting,2012,0,1,0,1
1189,COL,Wrestling,2012,0,0,1,1
1190,COL,Athletics,2012,0,1,0,1
1191,COL,Judo,2012,0,0,1,1
1192,COL,Cycling,2012,1,1,1,3
1193,COL,Weightlifting,2016,1,0,1,2
1194,COL,Boxing,2016,0,1,1,2
1195,COL,Athletics,2016,1,0,0,1
1196,COL,Judo,2016,0,1,0,1
1197,COL,Cycling,2016,1,0,1,2
1198,COL,Weightlifting,2020,0,1,0,1
1199,COL,Athletics,2020,0,2,0,2
1200,COL,Cycling BMX Racing,2020,0,1,1,2
1201,COL,Weightlifting,2024,0,2,0,2
1202,COL,Wrestling,2024,0,0,1,1
1203,COL,Artistic Gymnastics,2024,0,1,0,1
1204,CPV,Boxing,2024,0,0,1,1
1205,CRC,Swimming,1988,0,1,0,1
1206,CRC,Swimming,1996,1,0,0,1
1207,CRC,Swimming,2000,0,0,2,2
1208,CRO,Tennis,1992,0,0,3,3
1209,CRO,Basketball,1992,0,12,0,12
1210,CRO,Water Polo,1996,0,12,0,12
1211,CRO,Handball,1996,16,0,0,16
1212,CRO,Rowing,2000,0,0,9,9
1213,CRO,Weightlifting,2000,1,0,0,1
1214,CRO,Rowing,2004,0,2,0,2
1215,CRO,Tennis,2004,0,0,2,2
1216,CRO,Weightlifting,2004,0,0,1,1
1217,CRO,Swimming,2004,0,1,0,1
1218,CRO,Handball,2004,15,0,0,15
1219,CRO,Taekwondo,2008,0,0,2,2
1220,CRO,Athletics,2008,0,1,0,1
1221,CRO,Shooting,2008,0,0,1,1
1222,CRO,Gymnastics,2008,0,1,0,1
1223,CRO,Taekwondo,2012,0,0,1,1
1224,CRO,Rowing,2012,0,4,0,4
1225,CRO,Athletics,2012,1,0,0,1
1226,CRO,Shooting,2012,1,0,0,1
1227,CRO,Water Polo,2012,13,0,0,13
1228,CRO,Handball,2012,0,0,15,15
1229,CRO,Sailing,2016,2,1,0,3
1230,CRO,Rowing,2016,2,1,0,3
1231,CRO,Boxing,2016,0,0,1,1
1232,CRO,Athletics,2016,2,0,1,3
1233,CRO,Shooting,2016,1,0,0,1
1234,CRO,Water Polo,2016,0,13,0,13
1235,CRO,Taekwondo,2020,1,0,1,2
1236,CRO,Sailing,2020,0,1,0,1
1237,CRO,Rowing,2020,2,0,1,3
1238,CRO,Tennis,2020,2,2,0,4
1239,CRO,Artistic Gymnastics,2020,0,1,0,1
1240,CRO,Taekwondo,2024,0,0,1,1
1241,CRO,Rowing,2024,2,0,0,2
1242,CRO,Tennis,2024,0,1,0,1
1243,CRO,Athletics,2024,0,0,1,1
1244,CRO,Judo,2024,1,0,0,1
1245,CRO,Shooting,2024,0,0,1,1
1246,CRO,Water Polo,2024,0,13,0,13
1247,CUB,Fencing,1900,1,1,0,2
1248,CUB,Fencing,1904,5,0,0,5
1249,CUB,Sailing,1948,0,2,0,2
1250,CUB,Athletics,1964,0,1,0,1
1251,CUB,Boxing,1968,0,2,0,2
1252,CUB,Athletics,1968,0,8,0,8
1253,CUB,Boxing,1972,3,1,1,5
1254,CUB,Athletics,1972,0,0,5,5
1255,CUB,Basketball,1972,0,0,12,12
1256,CUB,Boxing,1976,3,3,2,8
1257,CUB,Athletics,1976,2,1,0,3
1258,CUB,Judo,1976,1,0,0,1
1259,CUB,Volleyball,1976,0,0,12,12
1260,CUB,Weightlifting,1980,1,0,1,2
1261,CUB,Boxing,1980,6,2,2,10
1262,CUB,Athletics,1980,1,2,1,4
1263,CUB,Judo,1980,0,3,0,3
1264,CUB,Shooting,1980,0,0,1,1
1265,CUB,Weightlifting,1992,0,1,0,1
1266,CUB,Wrestling,1992,2,0,3,5
1267,CUB,Boxing,1992,7,2,0,9
1268,CUB,Athletics,1992,2,4,7,13
1269,CUB,Judo,1992,1,1,3,5
1270,CUB,Fencing,1992,0,5,1,6
1271,CUB,Volleyball,1992,10,0,0,10
1272,CUB,Baseball,1992,20,0,0,20
1273,CUB,Weightlifting,1996,1,0,0,1
1274,CUB,Wrestling,1996,1,1,1,3
1275,CUB,Boxing,1996,4,3,0,7
1276,CUB,Athletics,1996,0,1,1,2
1277,CUB,Judo,1996,1,1,4,6
1278,CUB,Swimming,1996,0,1,1,2
1279,CUB,Fencing,1996,0,1,3,4
1280,CUB,Volleyball,1996,10,0,0,10
1281,CUB,Baseball,1996,20,0,0,20
1282,CUB,Taekwondo,2000,1,1,0,2
1283,CUB,Wrestling,2000,1,3,1,5
1284,CUB,Boxing,2000,4,0,2,6
1285,CUB,Athletics,2000,2,2,5,9
1286,CUB,Judo,2000,2,2,1,5
1287,CUB,Fencing,2000,0,0,3,3
1288,CUB,Volleyball,2000,8,0,0,8
1289,CUB,Canoeing,2000,0,3,0,3
1290,CUB,Baseball,2000,0,24,0,24
1291,CUB,Taekwondo,2004,0,1,0,1
1292,CUB,Wrestling,2004,1,1,1,3
1293,CUB,Boxing,2004,5,2,1,8
1294,CUB,Athletics,2004,2,1,2,5
1295,CUB,Judo,2004,0,1,5,6
1296,CUB,Shooting,2004,0,0,1,1
1297,CUB,Volleyball,2004,0,0,12,12
1298,CUB,Canoeing,2004,0,2,0,2
1299,CUB,Baseball,2004,24,0,0,24
1300,CUB,Taekwondo,2008,0,0,1,1
1301,CUB,Wrestling,2008,1,0,0,1
1302,CUB,Boxing,2008,0,4,4,8
1303,CUB,Athletics,2008,1,2,2,5
1304,CUB,Judo,2008,0,3,3,6
1305,CUB,Shooting,2008,0,0,1,1
1306,CUB,Cycling,2008,0,1,0,1
1307,CUB,Baseball,2008,0,24,0,24
1308,CUB,Taekwondo,2012,0,0,1,1
1309,CUB,Weightlifting,2012,0,0,1,1
1310,CUB,Wrestling,2012,1,0,1,2
1311,CUB,Boxing,2012,2,0,2,4
1312,CUB,Athletics,2012,0,1,1,2
1313,CUB,Judo,2012,1,2,0,3
1314,CUB,Shooting,2012,1,0,0,1
1315,CUB,Wrestling,2016,2,1,0,3
1316,CUB,Boxing,2016,3,0,3,6
1317,CUB,Athletics,2016,0,0,1,1
1318,CUB,Judo,2016,0,1,0,1
1319,CUB,Taekwondo,2020,0,0,1,1
1320,CUB,Wrestling,2020,2,0,1,3
1321,CUB,Boxing,2020,4,0,1,5
1322,CUB,Athletics,2020,0,1,2,3
1323,CUB,Judo,2020,0,1,0,1
1324,CUB,Shooting,2020,0,1,0,1
1325,CUB,Canoe Sprint,2020,2,0,0,2
1326,CUB,Taekwondo,2024,0,0,1,1
1327,CUB,Wrestling,2024,1,1,3,5
1328,CUB,Boxing,2024,1,0,1,2
1329,CUB,Canoe Sprint,2024,0,0,1,1
1330,CYP,Sailing,2012,0,1,0,1
1331,CYP,Sailing,2024,0,1,0,1
1332,CZE,Tennis,1996,0,2,1,3
1333,CZE,Athletics,1996,1,0,2,3
1334,CZE,Shooting,1996,0,0,1,1
1335,CZE,Canoeing,1996,3,3,0,6
1336,CZE,Boxing,2000,0,1,0,1
1337,CZE,Athletics,2000,1,1,0,2
1338,CZE,Shooting,2000,0,1,1,2
1339,CZE,Canoeing,2000,1,0,2,3
1340,CZE,Triathlon,2000,0,0,1,1
1341,CZE,Sailing,2004,0,1,0,1
1342,CZE,Rowing,2004,0,4,0,4
1343,CZE,Athletics,2004,1,0,2,3
1344,CZE,Shooting,2004,0,1,1,2
1345,CZE,Canoeing,2004,0,0,2,2
1346,CZE,Modern Pentathlon,2004,0,0,1,1
1347,CZE,Rowing,2008,0,1,0,1
1348,CZE,Athletics,2008,1,0,0,1
1349,CZE,Shooting,2008,2,1,0,3
1350,CZE,Canoeing,2008,0,2,0,2
1351,CZE,Rowing,2012,1,1,0,2
1352,CZE,Tennis,2012,0,2,0,2
1353,CZE,Athletics,2012,1,0,1,2
1354,CZE,Shooting,2012,0,0,1,1
1355,CZE,Cycling,2012,1,0,0,1
1356,CZE,Canoeing,2012,0,1,4,5
1357,CZE,Modern Pentathlon,2012,1,0,0,1
1358,CZE,Rowing,2016,0,0,1,1
1359,CZE,Tennis,2016,0,0,5,5
1360,CZE,Athletics,2016,0,0,1,1
1361,CZE,Judo,2016,1,0,0,1
1362,CZE,Cycling,2016,0,1,0,1
1363,CZE,Canoeing,2016,0,1,5,6
1364,CZE,Tennis,2020,2,1,0,3
1365,CZE,Athletics,2020,0,1,1,2
1366,CZE,Judo,2020,1,0,0,1
1367,CZE,Fencing,2020,0,0,1,1
1368,CZE,Shooting,2020,1,1,0,2
1369,CZE,Canoe Slalom,2020,1,1,0,2
1370,CZE,Canoe Sprint,2020,0,0,2,2
1371,CZE,Tennis,2024,2,0,0,2
1372,CZE,Athletics,2024,0,0,1,1
1373,CZE,Fencing,2024,0,0,4,4
1374,CZE,Canoe Sprint,2024,2,0,0,2
1375,DEN,Weightlifting,1896,1,1,0,2
1376,DEN,Fencing,1896,0,0,1,1
1377,DEN,Shooting,1896,0,1,2,3
1378,DEN,Athletics,1900,0,0,1,1
1379,DEN,Swimming,1900,0,0,1,1
1380,DEN,Shooting,1900,1,3,0,4
1381,DEN,Tug-Of-War,1900,3,0,0,3
1382,DEN,Wrestling,1906,2,1,1,4
1383,DEN,Football,1906,12,0,0,12
1384,DEN,Gymnastics,1906,0,18,0,18
1385,DEN,Wrestling,1908,0,0,3,3
1386,DEN,Swimming,1908,0,1,0,1
1387,DEN,Football,1908,0,13,0,13
1388,DEN,Sailing,1912,0,3,0,3
1389,DEN,Rowing,1912,5,0,5,10
1390,DEN,Tennis,1912,0,1,0,1
1391,DEN,Wrestling,1912,0,0,1,1
1392,DEN,Fencing,1912,0,1,0,1
1393,DEN,Football,1912,0,15,0,15
1394,DEN,Shooting,1912,0,1,7,8
1395,DEN,Gymnastics,1912,0,28,20,48
1396,DEN,Wrestling,1920,0,1,1,2
1397,DEN,Boxing,1920,0,3,0,3
1398,DEN,Athletics,1920,0,1,0,1
1399,DEN,Shooting,1920,5,2,0,7
1400,DEN,Hockey,1920,0,12,0,12
1401,DEN,Diving,1920,1,0,0,1
1402,DEN,Gymnastics,1920,20,25,0,45
1403,DEN,Sailing,1924,0,3,0,3
1404,DEN,Boxing,1924,1,2,0,3
1405,DEN,Fencing,1924,1,0,1,2
1406,DEN,Shooting,1924,0,0,1,1
1407,DEN,Equestrianism,1924,0,1,0,1
1408,DEN,Cycling,1924,0,2,0,2
1409,DEN,Art Competitions,1924,0,1,1,2
1410,DEN,Sailing,1928,0,4,0,4
1411,DEN,Boxing,1928,0,0,1,1
1412,DEN,Cycling,1928,6,0,1,7
1413,DEN,Art Competitions,1928,0,1,2,3
1414,DEN,Weightlifting,1932,0,1,0,1
1415,DEN,Wrestling,1932,0,1,0,1
1416,DEN,Boxing,1932,0,0,1,1
1417,DEN,Swimming,1932,0,0,1,1
1418,DEN,Cycling,1932,0,3,2,5
1419,DEN,Art Competitions,1932,0,2,0,2
1420,DEN,Rowing,1936,0,2,0,2
1421,DEN,Boxing,1936,0,0,1,1
1422,DEN,Swimming,1936,0,1,1,2
1423,DEN,Equestrianism,1936,0,0,1,1
1424,DEN,Sailing,1948,1,0,3,4
1425,DEN,Rowing,1948,3,6,5,14
1426,DEN,Wrestling,1948,0,0,1,1
1427,DEN,Boxing,1948,0,0,1,1
1428,DEN,Athletics,1948,0,0,1,1
1429,DEN,Swimming,1948,2,6,0,8
1430,DEN,Fencing,1948,0,1,0,1
1431,DEN,Football,1948,0,0,13,13
1432,DEN,Cycling,1948,0,0,1,1
1433,DEN,Diving,1948,0,0,1,1
1434,DEN,Canoeing,1948,1,3,0,4
1435,DEN,Art Competitions,1948,0,1,1,2
1436,DEN,Sailing,1952,1,0,0,1
1437,DEN,Rowing,1952,0,0,3,3
1438,DEN,Boxing,1952,0,0,1,1
1439,DEN,Fencing,1952,0,0,1,1
1440,DEN,Equestrianism,1952,0,1,0,1
1441,DEN,Canoeing,1952,2,0,0,2
1442,DEN,Sailing,1956,1,3,0,4
1443,DEN,Equestrianism,1956,0,1,0,1
1444,DEN,Canoeing,1956,0,0,1,1
1445,DEN,Sailing,1960,1,5,0,6
1446,DEN,Football,1960,0,12,0,12
1447,DEN,Canoeing,1960,1,0,4,5
1448,DEN,Sailing,1964,3,0,1,4
1449,DEN,Rowing,1964,4,0,0,4
1450,DEN,Cycling,1964,0,1,1,2
1451,DEN,Canoeing,1964,0,0,2,2
1452,DEN,Sailing,1968,0,3,0,3
1453,DEN,Rowing,1968,0,0,5,5
1454,DEN,Cycling,1968,5,3,0,8
1455,DEN,Canoeing,1968,0,0,1,1
1456,DEN,Cycling,1972,1,0,0,1
1457,DEN,Sailing,1976,3,0,0,3
1458,DEN,Cycling,1976,0,0,5,5
1459,DEN,Sailing,1980,3,2,0,5
1460,DEN,Swimming,1980,0,0,1,1
1461,DEN,Shooting,1980,1,0,0,1
1462,DEN,Cycling,1980,0,0,1,1
1463,DEN,Rowing,1984,0,0,9,9
1464,DEN,Shooting,1984,0,1,0,1
1465,DEN,Equestrianism,1984,0,1,0,1
1466,DEN,Canoeing,1984,0,1,1,2
1467,DEN,Sailing,1988,2,0,3,5
1468,DEN,Swimming,1988,0,1,0,1
1469,DEN,Cycling,1988,1,0,0,1
1470,DEN,Sailing,1992,3,0,2,5
1471,DEN,Boxing,1992,0,0,1,1
1472,DEN,Cycling,1992,0,0,5,5
1473,DEN,Canoeing,1992,0,2,0,2
1474,DEN,Badminton,1992,0,0,1,1
1475,DEN,Sailing,1996,1,0,0,1
1476,DEN,Rowing,1996,4,0,1,5
1477,DEN,Cycling,1996,0,1,0,1
1478,DEN,Handball,1996,15,0,0,15
1479,DEN,Badminton,1996,1,0,0,1
1480,DEN,Sailing,2000,3,0,0,3
1481,DEN,Rowing,2000,0,0,4,4
1482,DEN,Athletics,2000,0,1,0,1
1483,DEN,Shooting,2000,0,1,0,1
1484,DEN,Handball,2000,15,0,0,15
1485,DEN,Badminton,2000,0,1,0,1
1486,DEN,Sailing,2004,0,0,4,4
1487,DEN,Rowing,2004,4,0,0,4
1488,DEN,Athletics,2004,0,1,1,2
1489,DEN,Handball,2004,15,0,0,15
1490,DEN,Table Tennis,2004,0,0,2,2
1491,DEN,Badminton,2004,0,0,2,2
1492,DEN,Sailing,2008,2,0,0,2
1493,DEN,Rowing,2008,4,0,2,6
1494,DEN,Swimming,2008,0,0,1,1
1495,DEN,Equestrianism,2008,0,0,3,3
1496,DEN,Cycling,2008,0,5,0,5
1497,DEN,Canoeing,2008,0,2,0,2
1498,DEN,Sailing,2012,0,1,2,3
1499,DEN,Rowing,2012,2,1,4,7
1500,DEN,Shooting,2012,0,1,0,1
1501,DEN,Cycling,2012,1,0,0,1
1502,DEN,Badminton,2012,0,2,2,4
1503,DEN,Sailing,2016,0,0,3,3
1504,DEN,Rowing,2016,0,4,2,6
1505,DEN,Wrestling,2016,0,1,0,1
1506,DEN,Athletics,2016,0,1,0,1
1507,DEN,Swimming,2016,1,0,4,5
1508,DEN,Cycling,2016,0,1,6,7
1509,DEN,Canoeing,2016,0,1,0,1
1510,DEN,Handball,2016,14,0,0,14
1511,DEN,Badminton,2016,0,2,1,3
1512,DEN,Sailing,2020,1,0,0,1
1513,DEN,Rowing,2020,0,0,2,2
1514,DEN,Swimming,2020,0,0,1,1
1515,DEN,Shooting,2020,0,1,0,1
1516,DEN,Canoe Sprint,2020,0,0,2,2
1517,DEN,Cycling Track,2020,2,8,0,10
1518,DEN,Handball,2020,0,15,0,15
1519,DEN,Badminton,2020,1,0,0,1
1520,DEN,Taekwondo,2024,0,0,1,1
1521,DEN,Sailing,2024,0,1,0,1
1522,DEN,Wrestling,2024,0,0,1,1
1523,DEN,Canoe Sprint,2024,0,0,1,1
1524,DEN,Cycling Track,2024,0,0,1,1
1525,DEN,Equestrian,2024,0,4,0,4
1526,DEN,Handball,2024,16,0,15,31
1527,DEN,Badminton,2024,1,0,0,1
1528,DJI,Athletics,1988,0,0,1,1
1529,DMA,Athletics,2024,1,0,0,1
1530,DOM,Boxing,1984,0,0,1,1
1531,DOM,Athletics,2004,1,0,0,1
1532,DOM,Taekwondo,2008,0,1,0,1
1533,DOM,Boxing,2008,1,0,0,1
1534,DOM,Athletics,2012,1,1,0,2
1535,DOM,Taekwondo,2016,0,0,1,1
1536,DOM,Weightlifting,2020,0,1,1,2
1537,DOM,Athletics,2020,0,6,0,6
1538,DOM,Baseball/Softball,2020,0,0,24,24
1539,DOM,Boxing,2024,0,0,2,2
1540,DOM,Athletics,2024,1,0,0,1
1541,ECU,Athletics,1996,1,0,0,1
1542,ECU,Athletics,2008,0,1,0,1
1543,ECU,Weightlifting,2020,1,1,0,2
1544,ECU,Cycling Road,2020,1,0,0,1
1545,ECU,Weightlifting,2024,0,0,2,2
1546,ECU,Wrestling,2024,0,1,0,1
1547,ECU,Athletics,2024,1,2,0,3
1548,EGY,Weightlifting,1928,1,0,0,1
1549,EGY,Wrestling,1928,1,0,0,1
1550,EGY,Diving,1928,0,1,1,2
1551,EGY,Weightlifting,1936,2,1,2,5
1552,EGY,Weightlifting,1948,2,1,0,3
1553,EGY,Wrestling,1948,0,1,1,2
1554,EGY,Wrestling,1952,0,0,1,1
1555,EGY,Judo,1984,0,1,0,1
1556,EGY,Taekwondo,2004,0,0,1,1
1557,EGY,Wrestling,2004,1,0,0,1
1558,EGY,Boxing,2004,0,1,2,3
1559,EGY,Judo,2008,0,0,1,1
1560,EGY,Wrestling,2012,0,1,0,1
1561,EGY,Fencing,2012,0,1,0,1
1562,EGY,Taekwondo,2016,0,0,1,1
1563,EGY,Weightlifting,2016,0,0,2,2
1564,EGY,Taekwondo,2020,0,0,2,2
1565,EGY,Wrestling,2020,0,0,1,1
1566,EGY,Modern Pentathlon,2020,0,1,0,1
1567,EGY,Karate,2020,1,0,1,2
1568,EGY,Weightlifting,2024,0,1,0,1
1569,EGY,Fencing,2024,0,0,1,1
1570,EGY,Modern Pentathlon,2024,1,0,0,1
1571,EOR,Boxing,2024,0,0,1,1
1572,ERI,Athletics,2004,0,0,1,1
1573,ESP,Basque Pelota,1900,2,0,0,2
1574,ESP,Polo,1920,0,5,0,5
1575,ESP,Football,1920,0,18,0,18
1576,ESP,Equestrianism,1928,3,0,0,3
1577,ESP,Sailing,1932,0,0,1,1
1578,ESP,Equestrianism,1948,0,3,0,3
1579,ESP,Shooting,1952,0,1,0,1
1580,ESP,Hockey,1960,0,0,14,14
1581,ESP,Boxing,1972,0,0,1,1
1582,ESP,Sailing,1976,0,2,0,2
1583,ESP,Canoeing,1976,0,4,0,4
1584,ESP,Sailing,1980,2,0,0,2
1585,ESP,Athletics,1980,0,1,0,1
1586,ESP,Swimming,1980,0,0,1,1
1587,ESP,Hockey,1980,0,16,0,16
1588,ESP,Canoeing,1980,0,2,2,4
1589,ESP,Sailing,1984,2,0,0,2
1590,ESP,Rowing,1984,0,2,0,2
1591,ESP,Athletics,1984,0,0,1,1
1592,ESP,Basketball,1984,0,12,0,12
1593,ESP,Canoeing,1984,0,0,2,2
1594,ESP,Sailing,1988,1,0,0,1
1595,ESP,Tennis,1988,0,2,0,2
1596,ESP,Swimming,1988,0,0,1,1
1597,ESP,Shooting,1988,0,0,1,1
1598,ESP,Sailing,1992,7,1,0,8
1599,ESP,Tennis,1992,0,3,1,4
1600,ESP,Boxing,1992,0,1,0,1
1601,ESP,Athletics,1992,2,1,1,4
1602,ESP,Judo,1992,2,0,0,2
1603,ESP,Swimming,1992,1,0,0,1
1604,ESP,Football,1992,17,0,0,17
1605,ESP,Hockey,1992,15,0,0,15
1606,ESP,Cycling,1992,1,0,0,1
1607,ESP,Archery,1992,3,0,0,3
1608,ESP,Water Polo,1992,0,12,0,12
1609,ESP,Rhythmic Gymnastics,1992,0,1,0,1
1610,ESP,Sailing,1996,4,0,0,4
1611,ESP,Tennis,1996,0,2,2,4
1612,ESP,Boxing,1996,0,0,1,1
1613,ESP,Athletics,1996,0,1,1,2
1614,ESP,Judo,1996,0,1,2,3
1615,ESP,Hockey,1996,0,16,0,16
1616,ESP,Cycling,1996,1,1,0,2
1617,ESP,Water Polo,1996,12,0,0,12
1618,ESP,Handball,1996,0,0,16,16
1619,ESP,Rhythmic Gymnastics,1996,6,0,0,6
1620,ESP,Taekwondo,2000,0,1,0,1
1621,ESP,Tennis,2000,0,0,2,2
1622,ESP,Boxing,2000,0,1,0,1
1623,ESP,Athletics,2000,0,0,1,1
1624,ESP,Judo,2000,1,0,0,1
1625,ESP,Swimming,2000,0,0,1,1
1626,ESP,Football,2000,0,17,0,17
1627,ESP,Cycling,2000,1,0,1,2
1628,ESP,Gymnastics,2000,1,0,0,1
1629,ESP,Handball,2000,0,0,15,15
1630,ESP,Sailing,2004,2,3,0,5
1631,ESP,Tennis,2004,0,2,0,2
1632,ESP,Athletics,2004,0,1,2,3
1633,ESP,Shooting,2004,0,1,0,1
1634,ESP,Equestrianism,2004,0,4,1,5
1635,ESP,Cycling,2004,0,3,5,8
1636,ESP,Canoeing,2004,1,1,0,2
1637,ESP,Beach Volleyball,2004,0,2,0,2
1638,ESP,Gymnastics,2004,1,0,1,2
1639,ESP,Sailing,2008,2,2,0,4
1640,ESP,Tennis,2008,1,2,0,3
1641,ESP,Fencing,2008,0,0,1,1
1642,ESP,Hockey,2008,0,16,0,16
1643,ESP,Basketball,2008,0,12,0,12
1644,ESP,Cycling,2008,2,2,1,5
1645,ESP,Canoeing,2008,2,2,0,4
1646,ESP,Gymnastics,2008,0,1,0,1
1647,ESP,Handball,2008,0,0,14,14
1648,ESP,Synchronized Swimming,2008,0,10,0,10
1649,ESP,Taekwondo,2012,1,2,0,3
1650,ESP,Sailing,2012,4,0,0,4
1651,ESP,Wrestling,2012,0,0,1,1
1652,ESP,Swimming,2012,0,2,0,2
1653,ESP,Basketball,2012,0,12,0,12
1654,ESP,Canoeing,2012,0,2,1,3
1655,ESP,Triathlon,2012,0,1,0,1
1656,ESP,Water Polo,2012,0,12,0,12
1657,ESP,Handball,2012,0,0,15,15
1658,ESP,Synchronized Swimming,2012,0,2,8,10
1659,ESP,Taekwondo,2016,0,1,1,2
1660,ESP,Tennis,2016,2,0,0,2
1661,ESP,Weightlifting,2016,0,0,1,1
1662,ESP,Athletics,2016,1,1,0,2
1663,ESP,Swimming,2016,1,0,1,2
1664,ESP,Basketball,2016,0,12,12,24
1665,ESP,Cycling,2016,0,0,1,1
1666,ESP,Canoeing,2016,4,0,1,5
1667,ESP,Rhythmic Gymnastics,2016,0,5,0,5
1668,ESP,Badminton,2016,1,0,0,1
1669,ESP,Taekwondo,2020,0,1,0,1
1670,ESP,Sailing,2020,0,0,3,3
1671,ESP,Tennis,2020,0,0,1,1
1672,ESP,Athletics,2020,0,0,1,1
1673,ESP,Artistic Gymnastics,2020,0,1,0,1
1674,ESP,Football,2020,0,22,0,22
1675,ESP,Shooting,2020,2,0,0,2
1676,ESP,Water Polo,2020,0,13,0,13
1677,ESP,Canoe Slalom,2020,0,1,0,1
1678,ESP,Canoe Sprint,2020,0,5,0,5
1679,ESP,Handball,2020,0,0,16,16
1680,ESP,Karate,2020,1,1,0,2
1681,ESP,Sport Climbing,2020,1,0,0,1
1682,ESP,Cycling Mountain Bike,2020,0,0,1,1
1683,ESP,Sailing,2024,2,0,0,2
1684,ESP,Tennis,2024,0,1,2,3
1685,ESP,Boxing,2024,0,1,1,2
1686,ESP,Athletics,2024,3,1,1,5
1687,ESP,Judo,2024,0,0,1,1
1688,ESP,Football,2024,22,0,0,22
1689,ESP,Water Polo,2024,13,0,0,13
1690,ESP,Canoe Slalom,2024,0,0,1,1
1691,ESP,Canoe Sprint,2024,0,0,6,6
1692,ESP,Handball,2024,0,0,15,15
1693,ESP,3x3 Basketball,2024,0,4,0,4
1694,ESP,Artistic Swimming,2024,0,0,9,9
1695,EST,Weightlifting,1920,1,1,0,2
1696,EST,Athletics,1920,0,1,0,1
1697,EST,Weightlifting,1924,0,1,2,3
1698,EST,Wrestling,1924,1,0,1,2
1699,EST,Athletics,1924,0,0,1,1
1700,EST,Sailing,1928,0,0,5,5
1701,EST,Weightlifting,1928,0,1,0,1
1702,EST,Wrestling,1928,2,0,1,3
1703,EST,Weightlifting,1936,0,0,1,1
1704,EST,Wrestling,1936,2,1,2,5
1705,EST,Boxing,1936,0,1,0,1
1706,EST,Sailing,1992,0,0,2,2
1707,EST,Cycling,1992,1,0,0,1
1708,EST,Athletics,2000,1,0,0,1
1709,EST,Judo,2000,0,0,2,2
1710,EST,Rowing,2004,0,1,0,1
1711,EST,Athletics,2004,0,0,1,1
1712,EST,Judo,2004,0,0,1,1
1713,EST,Rowing,2008,0,2,0,2
1714,EST,Athletics,2008,1,0,0,1
1715,EST,Wrestling,2012,0,1,0,1
1716,EST,Athletics,2012,0,0,1,1
1717,EST,Rowing,2016,0,0,4,4
1718,EST,Fencing,2020,4,0,1,5
1719,ETH,Athletics,1960,1,0,0,1
1720,ETH,Athletics,1964,1,0,0,1
1721,ETH,Athletics,1968,1,1,0,2
1722,ETH,Athletics,1972,0,0,2,2
1723,ETH,Athletics,1980,2,0,2,4
1724,ETH,Athletics,1992,1,0,2,3
1725,ETH,Athletics,1996,2,0,1,3
1726,ETH,Athletics,2000,4,1,3,8
1727,ETH,Athletics,2004,2,3,2,7
1728,ETH,Athletics,2008,4,1,2,7
1729,ETH,Athletics,2012,3,1,3,7
1730,ETH,Athletics,2016,1,2,5,8
1731,ETH,Athletics,2020,1,1,2,4
1732,ETH,Athletics,2024,1,3,0,4
1733,EUN,Rowing,1992,0,0,4,4
1734,EUN,Tennis,1992,0,0,3,3
1735,EUN,Weightlifting,1992,5,4,0,9
1736,EUN,Wrestling,1992,6,5,5,16
1737,EUN,Boxing,1992,0,1,1,2
1738,EUN,Athletics,1992,12,14,3,29
1739,EUN,Judo,1992,2,0,2,4
1740,EUN,Swimming,1992,11,14,5,30
1741,EUN,Fencing,1992,5,2,6,13
1742,EUN,Shooting,1992,5,2,1,8
1743,EUN,Volleyball,1992,0,8,0,8
1744,EUN,Basketball,1992,12,0,0,12
1745,EUN,Diving,1992,0,2,1,3
1746,EUN,Canoeing,1992,2,1,0,3
1747,EUN,Archery,1992,0,0,4,4
1748,EUN,Water Polo,1992,0,0,13,13
1749,EUN,Modern Pentathlon,1992,0,3,1,4
1750,EUN,Gymnastics,1992,19,5,4,28
1751,EUN,Handball,1992,12,0,13,25
1752,EUN,Rhythmic Gymnastics,1992,1,0,1,2
1753,FIJ,Rugby Sevens,2016,13,0,0,13
1754,FIJ,Rugby Sevens,2020,13,0,13,26
1755,FIJ,Rugby Sevens,2024,0,14,0,14
1756,FIN,Wrestling,1906,1,1,0,2
1757,FIN,Athletics,1906,1,0,1,2
1758,FIN,Wrestling,1908,1,1,1,3
1759,FIN,Athletics,1908,0,0,1,1
1760,FIN,Gymnastics,1908,0,0,26,26
1761,FIN,Sailing,1912,0,7,12,19
1762,FIN,Wrestling,1912,3,2,2,7
1763,FIN,Athletics,1912,6,11,3,20
1764,FIN,Shooting,1912,0,0,5,5
1765,FIN,Gymnastics,1912,0,20,0,20
1766,FIN,Wrestling,1920,5,5,2,12
1767,FIN,Athletics,1920,14,4,3,21
1768,FIN,Swimming,1920,0,0,2,2
1769,FIN,Shooting,1920,0,5,10,15
1770,FIN,Figure Skating,1920,2,0,0,2
1771,FIN,Sailing,1924,0,0,1,1
1772,FIN,Wrestling,1924,4,7,5,16
1773,FIN,Athletics,1924,20,5,2,27
1774,FIN,Shooting,1924,0,1,7,8
1775,FIN,Sailing,1928,0,0,1,1
1776,FIN,Wrestling,1928,3,3,3,9
1777,FIN,Athletics,1928,5,5,4,14
1778,FIN,Gymnastics,1928,0,0,1,1
1779,FIN,Wrestling,1932,2,3,3,8
1780,FIN,Boxing,1932,0,0,1,1
1781,FIN,Athletics,1932,3,4,4,11
1782,FIN,Gymnastics,1932,0,1,8,9
1783,FIN,Wrestling,1936,2,1,3,6
1784,FIN,Boxing,1936,1,0,0,1
1785,FIN,Athletics,1936,3,5,2,10
1786,FIN,Gymnastics,1936,1,0,8,9
1787,FIN,Art Competitions,1936,1,0,0,1
1788,FIN,Wrestling,1948,1,1,1,3
1789,FIN,Athletics,1948,1,2,0,3
1790,FIN,Shooting,1948,0,1,0,1
1791,FIN,Canoeing,1948,0,1,4,5
1792,FIN,Gymnastics,1948,13,2,2,17
1793,FIN,Art Competitions,1948,2,1,1,4
1794,FIN,Sailing,1952,0,0,5,5
1795,FIN,Rowing,1952,0,0,4,4
1796,FIN,Wrestling,1952,1,1,2,4
1797,FIN,Boxing,1952,1,0,4,5
1798,FIN,Athletics,1952,0,0,1,1
1799,FIN,Shooting,1952,0,1,1,2
1800,FIN,Canoeing,1952,6,1,1,8
1801,FIN,Modern Pentathlon,1952,0,0,3,3
1802,FIN,Gymnastics,1952,0,0,8,8
1803,FIN,Rowing,1956,0,0,5,5
1804,FIN,Wrestling,1956,2,0,2,4
1805,FIN,Boxing,1956,0,0,1,1
1806,FIN,Athletics,1956,0,0,3,3
1807,FIN,Shooting,1956,1,0,1,2
1808,FIN,Modern Pentathlon,1956,0,1,4,5
1809,FIN,Gymnastics,1956,0,0,6,6
1810,FIN,Rowing,1960,0,0,2,2
1811,FIN,Boxing,1960,0,0,1,1
1812,FIN,Athletics,1960,0,0,1,1
1813,FIN,Shooting,1960,0,1,0,1
1814,FIN,Gymnastics,1960,1,0,0,1
1815,FIN,Boxing,1964,0,0,1,1
1816,FIN,Athletics,1964,1,0,0,1
1817,FIN,Shooting,1964,2,0,0,2
1818,FIN,Gymnastics,1964,0,0,1,1
1819,FIN,Weightlifting,1968,1,0,0,1
1820,FIN,Boxing,1968,0,0,1,1
1821,FIN,Athletics,1968,0,1,0,1
1822,FIN,Gymnastics,1968,0,1,0,1
1823,FIN,Wrestling,1972,0,0,1,1
1824,FIN,Boxing,1972,0,1,0,1
1825,FIN,Athletics,1972,3,0,1,4
1826,FIN,Archery,1972,0,0,1,1
1827,FIN,Modern Pentathlon,1972,0,0,3,3
1828,FIN,Rowing,1976,1,0,0,1
1829,FIN,Wrestling,1976,1,0,0,1
1830,FIN,Athletics,1976,2,2,0,4
1831,FIN,Sailing,1980,1,0,2,3
1832,FIN,Rowing,1980,1,0,0,1
1833,FIN,Wrestling,1980,0,0,1,1
1834,FIN,Athletics,1980,0,1,1,2
1835,FIN,Archery,1980,1,0,1,2
1836,FIN,Rowing,1984,1,0,0,1
1837,FIN,Weightlifting,1984,0,0,2,2
1838,FIN,Wrestling,1984,1,1,1,3
1839,FIN,Boxing,1984,0,0,1,1
1840,FIN,Athletics,1984,2,1,1,4
1841,FIN,Shooting,1984,0,0,1,1
1842,FIN,Wrestling,1988,0,1,1,2
1843,FIN,Athletics,1988,1,0,1,2
1844,FIN,Boxing,1992,0,0,1,1
1845,FIN,Athletics,1992,0,1,0,1
1846,FIN,Swimming,1992,0,0,1,1
1847,FIN,Canoeing,1992,1,0,0,1
1848,FIN,Archery,1992,0,3,0,3
1849,FIN,Wrestling,1996,0,1,0,1
1850,FIN,Athletics,1996,1,0,1,2
1851,FIN,Swimming,1996,0,1,0,1
1852,FIN,Sailing,2000,2,0,0,2
1853,FIN,Wrestling,2000,0,0,1,1
1854,FIN,Athletics,2000,1,0,0,1
1855,FIN,Shooting,2000,0,1,0,1
1856,FIN,Wrestling,2004,0,1,0,1
1857,FIN,Shooting,2004,0,1,0,1
1858,FIN,Rowing,2008,0,2,0,2
1859,FIN,Athletics,2008,0,0,1,1
1860,FIN,Shooting,2008,1,0,1,2
1861,FIN,Sailing,2012,0,1,3,4
1862,FIN,Athletics,2012,0,0,1,1
1863,FIN,Boxing,2016,0,0,1,1
1864,FIN,Boxing,2020,0,0,1,1
1865,FIN,Swimming,2020,0,0,1,1
1866,FRA,Athletics,1896,0,1,1,2
1867,FRA,Fencing,1896,1,2,0,3
1868,FRA,Cycling,1896,4,1,1,6
1869,FRA,Sailing,1900,10,33,29,72
1870,FRA,Rowing,1900,6,7,3,16
1871,FRA,Tennis,1900,0,3,2,5
1872,FRA,Athletics,1900,0,8,2,10
1873,FRA,Rugby,1900,15,0,0,15
1874,FRA,Swimming,1900,1,6,5,12
1875,FRA,Polo,1900,0,1,3,4
1876,FRA,Fencing,1900,5,5,5,15
1877,FRA,Football,1900,0,13,0,13
1878,FRA,Shooting,1900,2,6,6,14
1879,FRA,Equestrianism,1900,2,2,4,8
1880,FRA,Cycling,1900,2,1,2,5
1881,FRA,Archery,1900,4,5,4,13
1882,FRA,Water Polo,1900,0,0,14,14
1883,FRA,Gymnastics,1900,1,1,1,3
1884,FRA,Tug-Of-War,1900,0,5,0,5
1885,FRA,Cricket,1900,0,3,0,3
1886,FRA,Croquet,1900,4,2,2,8
1887,FRA,Athletics,1904,0,2,0,2
1888,FRA,Rowing,1906,1,6,11,18
1889,FRA,Tennis,1906,5,1,0,6
1890,FRA,Weightlifting,1906,0,0,1,1
1891,FRA,Athletics,1906,1,0,0,1
1892,FRA,Fencing,1906,6,1,1,8
1893,FRA,Football,1906,0,3,0,3
1894,FRA,Shooting,1906,4,3,9,16
1895,FRA,Cycling,1906,1,2,4,7
1896,FRA,Gymnastics,1906,2,0,2,4
1897,FRA,Sailing,1908,0,0,3,3
1898,FRA,Athletics,1908,0,1,5,6
1899,FRA,Fencing,1908,8,1,1,10
1900,FRA,Shooting,1908,0,0,10,10
1901,FRA,Cycling,1908,2,2,2,6
1902,FRA,Archery,1908,1,1,1,3
1903,FRA,Gymnastics,1908,0,0,1,1
1904,FRA,Motorboating,1908,1,0,0,1
1905,FRA,Sailing,1912,3,0,0,3
1906,FRA,Tennis,1912,4,0,4,8
1907,FRA,Athletics,1912,0,5,0,5
1908,FRA,Shooting,1912,2,0,0,2
1909,FRA,Equestrianism,1912,1,4,1,6
1910,FRA,Gymnastics,1912,0,1,0,1
1911,FRA,Art Competitions,1912,0,1,0,1
1912,FRA,Sailing,1920,0,3,0,3
1913,FRA,Rowing,1920,0,3,2,5
1914,FRA,Tennis,1920,3,0,4,7
1915,FRA,Weightlifting,1920,2,0,1,3
1916,FRA,Boxing,1920,1,1,1,3
1917,FRA,Athletics,1920,1,5,4,10
1918,FRA,Rugby,1920,0,15,0,15
1919,FRA,Fencing,1920,1,14,9,24
1920,FRA,Shooting,1920,0,6,0,6
1921,FRA,Equestrianism,1920,0,4,0,4
1922,FRA,Cycling,1920,4,0,1,5
1923,FRA,Archery,1920,1,18,8,27
1924,FRA,Gymnastics,1920,0,1,27,28
1925,FRA,Art Competitions,1920,0,1,0,1
1926,FRA,Sailing,1924,0,0,5,5
1927,FRA,Rowing,1924,0,9,0,9
1928,FRA,Tennis,1924,0,4,2,6
1929,FRA,Weightlifting,1924,2,0,0,2
1930,FRA,Wrestling,1924,1,0,0,1
1931,FRA,Boxing,1924,0,0,1,1
1932,FRA,Athletics,1924,0,0,8,8
1933,FRA,Rugby,1924,0,19,0,19
1934,FRA,Fencing,1924,16,3,0,19
1935,FRA,Shooting,1924,1,5,0,6
1936,FRA,Equestrianism,1924,0,0,1,1
1937,FRA,Cycling,1924,8,0,2,10
1938,FRA,Water Polo,1924,7,0,0,7
1939,FRA,Gymnastics,1924,1,11,1,13
1940,FRA,Art Competitions,1924,1,0,2,3
1941,FRA,Sailing,1928,6,0,0,6
1942,FRA,Rowing,1928,0,3,0,3
1943,FRA,Weightlifting,1928,1,1,1,3
1944,FRA,Wrestling,1928,0,1,2,3
1945,FRA,Boxing,1928,0,1,0,1
1946,FRA,Athletics,1928,1,1,1,3
1947,FRA,Fencing,1928,2,13,0,15
1948,FRA,Equestrianism,1928,0,2,0,2
1949,FRA,Cycling,1928,1,0,0,1
1950,FRA,Water Polo,1928,0,0,9,9
1951,FRA,Art Competitions,1928,1,2,1,4
1952,FRA,Sailing,1932,1,0,0,1
1953,FRA,Rowing,1932,0,0,3,3
1954,FRA,Weightlifting,1932,3,0,0,3
1955,FRA,Wrestling,1932,1,0,1,2
1956,FRA,Athletics,1932,0,0,1,1
1957,FRA,Swimming,1932,0,1,0,1
1958,FRA,Fencing,1932,12,1,0,13
1959,FRA,Equestrianism,1932,4,1,0,5
1960,FRA,Cycling,1932,2,5,1,8
1961,FRA,Art Competitions,1932,3,0,0,3
1962,FRA,Rowing,1936,0,0,8,8
1963,FRA,Weightlifting,1936,1,0,0,1
1964,FRA,Wrestling,1936,1,0,0,1
1965,FRA,Boxing,1936,2,0,0,2
1966,FRA,Fencing,1936,0,7,6,13
1967,FRA,Shooting,1936,0,0,1,1
1968,FRA,Equestrianism,1936,0,3,0,3
1969,FRA,Cycling,1936,9,2,3,14
1970,FRA,Canoeing,1936,0,1,0,1
1971,FRA,Wrestling,1948,0,0,1,1
1972,FRA,Athletics,1948,2,6,3,11
1973,FRA,Swimming,1948,0,0,5,5
1974,FRA,Fencing,1948,13,1,0,14
1975,FRA,Equestrianism,1948,4,1,1,6
1976,FRA,Basketball,1948,0,14,0,14
1977,FRA,Cycling,1948,6,0,6,12
1978,FRA,Canoeing,1948,0,0,6,6
1979,FRA,Art Competitions,1948,1,0,2,3
1980,FRA,Rowing,1952,3,4,0,7
1981,FRA,Boxing,1952,0,0,1,1
1982,FRA,Athletics,1952,0,2,0,2
1983,FRA,Swimming,1952,1,1,4,6
1984,FRA,Fencing,1952,7,0,6,13
1985,FRA,Equestrianism,1952,1,1,1,3
1986,FRA,Cycling,1952,0,0,4,4
1987,FRA,Diving,1952,0,1,0,1
1988,FRA,Canoeing,1952,2,0,1,3
1989,FRA,Rowing,1956,0,0,4,4
1990,FRA,Weightlifting,1956,0,0,1,1
1991,FRA,Boxing,1956,0,0,2,2
1992,FRA,Athletics,1956,1,0,0,1
1993,FRA,Fencing,1956,1,6,6,13
1994,FRA,Cycling,1956,5,5,0,10
1995,FRA,Canoeing,1956,0,2,0,2
1996,FRA,Rowing,1960,0,5,0,5
1997,FRA,Wrestling,1960,0,0,1,1
1998,FRA,Athletics,1960,0,1,1,2
1999,FRA,Equestrianism,1960,0,0,4,4
2000,FRA,Rowing,1964,0,3,0,3
2001,FRA,Boxing,1964,0,1,0,1
2002,FRA,Athletics,1964,0,1,4,5
2003,FRA,Swimming,1964,0,1,0,1
2004,FRA,Fencing,1964,0,2,11,13
2005,FRA,Equestrianism,1964,1,3,0,4
2006,FRA,Cycling,1964,0,0,2,2
2007,FRA,Canoeing,1964,0,2,0,2
2008,FRA,Wrestling,1968,0,2,0,2
2009,FRA,Athletics,1968,1,0,4,5
2010,FRA,Swimming,1968,0,0,1,1
2011,FRA,Fencing,1968,5,0,1,6
2012,FRA,Equestrianism,1968,1,3,0,4
2013,FRA,Cycling,1968,5,0,1,6
2014,FRA,Modern Pentathlon,1968,0,0,3,3
2015,FRA,Sailing,1972,1,2,0,3
2016,FRA,Athletics,1972,0,1,4,5
2017,FRA,Judo,1972,0,0,3,3
2018,FRA,Fencing,1972,0,1,6,7
2019,FRA,Shooting,1972,0,1,0,1
2020,FRA,Cycling,1972,1,0,0,1
2021,FRA,Canoeing,1972,0,0,2,2
2022,FRA,Weightlifting,1976,0,1,0,1
2023,FRA,Athletics,1976,1,0,0,1
2024,FRA,Judo,1976,0,0,1,1
2025,FRA,Fencing,1976,0,5,6,11
2026,FRA,Equestrianism,1976,4,0,0,4
2027,FRA,Cycling,1976,0,1,0,1
2028,FRA,Gymnastics,1976,0,0,1,1
2029,FRA,Athletics,1980,0,0,4,4
2030,FRA,Judo,1980,2,1,1,4
2031,FRA,Fencing,1980,16,1,1,18
2032,FRA,Cycling,1980,0,2,0,2
2033,FRA,Canoeing,1980,0,1,0,1
2034,FRA,Sailing,1984,0,0,2,2
2035,FRA,Boxing,1984,0,0,1,1
2036,FRA,Athletics,1984,1,1,2,4
2037,FRA,Judo,1984,0,1,2,3
2038,FRA,Swimming,1984,0,1,1,2
2039,FRA,Fencing,1984,2,10,11,23
2040,FRA,Football,1984,16,0,0,16
2041,FRA,Shooting,1984,1,1,0,2
2042,FRA,Cycling,1984,0,0,1,1
2043,FRA,Canoeing,1984,0,2,7,9
2044,FRA,Modern Pentathlon,1984,0,0,3,3
2045,FRA,Gymnastics,1984,0,0,1,1
2046,FRA,Sailing,1988,4,0,0,4
2047,FRA,Boxing,1988,0,1,0,1
2048,FRA,Athletics,1988,0,0,4,4
2049,FRA,Judo,1988,1,0,1,2
2050,FRA,Swimming,1988,0,0,2,2
2051,FRA,Fencing,1988,6,1,0,7
2052,FRA,Shooting,1988,0,1,0,1
2053,FRA,Equestrianism,1988,1,1,4,6
2054,FRA,Canoeing,1988,0,0,2,2
2055,FRA,Sailing,1992,3,0,0,3
2056,FRA,Athletics,1992,1,0,0,1
2057,FRA,Judo,1992,2,1,4,7
2058,FRA,Swimming,1992,0,0,3,3
2059,FRA,Fencing,1992,2,0,7,9
2060,FRA,Shooting,1992,0,1,0,1
2061,FRA,Equestrianism,1992,0,0,4,4
2062,FRA,Cycling,1992,0,1,4,5
2063,FRA,Canoeing,1992,0,1,5,6
2064,FRA,Archery,1992,1,0,0,1
2065,FRA,Handball,1992,0,0,16,16
2066,FRA,Table Tennis,1992,0,1,0,1
2067,FRA,Rowing,1996,0,4,6,10
2068,FRA,Wrestling,1996,0,1,0,1
2069,FRA,Athletics,1996,3,0,1,4
2070,FRA,Judo,1996,3,0,3,6
2071,FRA,Fencing,1996,4,2,5,11
2072,FRA,Shooting,1996,1,0,1,2
2073,FRA,Equestrianism,1996,0,0,1,1
2074,FRA,Cycling,1996,8,3,1,12
2075,FRA,Canoeing,1996,2,0,2,4
2076,FRA,Taekwondo,2000,0,0,1,1
2077,FRA,Rowing,2000,6,0,2,8
2078,FRA,Tennis,2000,0,0,1,1
2079,FRA,Boxing,2000,1,0,1,2
2080,FRA,Judo,2000,2,2,2,6
2081,FRA,Swimming,2000,0,1,0,1
2082,FRA,Fencing,2000,4,9,1,14
2083,FRA,Shooting,2000,1,1,0,2
2084,FRA,Basketball,2000,0,12,0,12
2085,FRA,Cycling,2000,7,2,1,10
2086,FRA,Canoeing,2000,1,1,1,3
2087,FRA,Gymnastics,2000,0,2,0,2
2088,FRA,Synchronized Swimming,2000,0,0,2,2
2089,FRA,Table Tennis,2000,0,0,2,2
2090,FRA,Taekwondo,2004,0,1,1,2
2091,FRA,Sailing,2004,1,0,2,3
2092,FRA,Rowing,2004,2,2,0,4
2093,FRA,Tennis,2004,0,1,0,1
2094,FRA,Wrestling,2004,0,0,2,2
2095,FRA,Boxing,2004,0,1,0,1
2096,FRA,Athletics,2004,0,0,5,5
2097,FRA,Judo,2004,0,1,0,1
2098,FRA,Swimming,2004,1,2,3,6
2099,FRA,Fencing,2004,8,1,5,14
2100,FRA,Equestrianism,2004,5,0,0,5
2101,FRA,Cycling,2004,1,1,3,5
2102,FRA,Canoeing,2004,2,0,1,3
2103,FRA,Gymnastics,2004,1,0,0,1
2104,FRA,Taekwondo,2008,0,0,1,1
2105,FRA,Sailing,2008,0,1,3,4
2106,FRA,Rowing,2008,0,0,8,8
2107,FRA,Weightlifting,2008,0,1,0,1
2108,FRA,Wrestling,2008,1,0,1,2
2109,FRA,Boxing,2008,0,2,1,3
2110,FRA,Athletics,2008,0,1,1,2
2111,FRA,Judo,2008,0,2,2,4
2112,FRA,Swimming,2008,1,7,3,11
2113,FRA,Fencing,2008,6,2,0,8
2114,FRA,Shooting,2008,0,0,1,1
2115,FRA,Cycling,2008,2,6,1,9
2116,FRA,Canoeing,2008,0,1,2,3
2117,FRA,Archery,2008,0,0,3,3
2118,FRA,Gymnastics,2008,0,1,1,2
2119,FRA,Handball,2008,15,0,0,15
2120,FRA,Taekwondo,2012,0,1,1,2
2121,FRA,Sailing,2012,0,0,1,1
2122,FRA,Rowing,2012,0,2,0,2
2123,FRA,Tennis,2012,0,2,2,4
2124,FRA,Wrestling,2012,0,0,1,1
2125,FRA,Athletics,2012,1,1,4,6
2126,FRA,Judo,2012,2,0,5,7
2127,FRA,Swimming,2012,9,6,6,21
2128,FRA,Shooting,2012,0,1,1,2
2129,FRA,Basketball,2012,0,12,0,12
2130,FRA,Cycling,2012,1,5,0,6
2131,FRA,Canoeing,2012,2,0,0,2
2132,FRA,Gymnastics,2012,0,0,1,1
2133,FRA,Handball,2012,15,0,0,15
2134,FRA,Taekwondo,2016,0,1,0,1
2135,FRA,Sailing,2016,1,0,3,4
2136,FRA,Rowing,2016,2,0,4,6
2137,FRA,Boxing,2016,2,2,2,6
2138,FRA,Athletics,2016,0,3,3,6
2139,FRA,Judo,2016,2,2,1,5
2140,FRA,Swimming,2016,0,7,1,8
2141,FRA,Fencing,2016,4,4,1,9
2142,FRA,Shooting,2016,0,1,1,2
2143,FRA,Equestrianism,2016,8,1,0,9
2144,FRA,Cycling,2016,0,0,3,3
2145,FRA,Canoeing,2016,1,1,2,4
2146,FRA,Archery,2016,0,1,0,1
2147,FRA,Modern Pentathlon,2016,0,1,0,1
2148,FRA,Handball,2016,0,31,0,31
2149,FRA,Taekwondo,2020,0,0,1,1
2150,FRA,Sailing,2020,0,2,2,4
2151,FRA,Rowing,2020,2,2,0,4
2152,FRA,Athletics,2020,0,1,0,1
2153,FRA,Judo,2020,12,3,3,18
2154,FRA,Swimming,2020,0,1,0,1
2155,FRA,Fencing,2020,5,8,1,14
2156,FRA,Shooting,2020,1,0,0,1
2157,FRA,Volleyball,2020,12,0,0,12
2158,FRA,Basketball,2020,0,12,12,24
2159,FRA,Rugby Sevens,2020,0,13,0,13
2160,FRA,Triathlon,2020,0,0,5,5
2161,FRA,Cycling Track,2020,0,0,7,7
2162,FRA,Equestrian,2020,0,0,3,3
2163,FRA,Handball,2020,32,0,0,32
2164,FRA,Karate,2020,1,0,0,1
2165,FRA,Taekwondo,2024,1,0,1,2
2166,FRA,Sailing,2024,0,1,2,3
2167,FRA,Boxing,2024,0,2,1,3
2168,FRA,Athletics,2024,0,1,0,1
2169,FRA,Judo,2024,15,2,6,23
2170,FRA,Swimming,2024,4,1,7,12
2171,FRA,Fencing,2024,1,7,8,16
2172,FRA,Football,2024,0,21,0,21
2173,FRA,Shooting,2024,0,1,0,1
2174,FRA,Volleyball,2024,13,0,0,13
2175,FRA,Basketball,2024,0,24,0,24
2176,FRA,Rugby Sevens,2024,13,0,0,13
2177,FRA,Cycling BMX Freestyle,2024,0,0,1,1
2178,FRA,Archery,2024,0,3,1,4
2179,FRA,Triathlon,2024,1,0,1,2
2180,FRA,Modern Pentathlon,2024,0,1,0,1
2181,FRA,Canoe Slalom,2024,1,2,0,3
2182,FRA,Cycling Road,2024,0,1,1,2
2183,FRA,Cycling Track,2024,1,0,0,1
2184,FRA,Equestrian,2024,0,4,4,8
2185,FRA,Surfing,2024,1,0,1,2
2186,FRA,Cycling BMX Racing,2024,1,1,1,3
2187,FRA,Handball,2024,0,17,0,17
2188,FRA,Breaking,2024,0,1,0,1
2189,FRA,Table Tennis,2024,0,0,4,4
2190,FRA,3x3 Basketball,2024,0,4,0,4
2191,FRA,Cycling Mountain Bike,2024,1,1,0,2
2192,FRG,Sailing,1968,0,2,0,2
2193,FRG,Rowing,1968,10,1,0,11
2194,FRG,Wrestling,1968,0,0,1,1
2195,FRG,Boxing,1968,0,0,1,1
2196,FRG,Athletics,1968,1,4,6,11
2197,FRG,Swimming,1968,0,0,5,5
2198,FRG,Shooting,1968,1,1,1,3
2199,FRG,Equestrianism,1968,3,1,4,8
2200,FRG,Cycling,1968,0,5,0,5
2201,FRG,Canoeing,1968,2,2,0,4
2202,FRG,Sailing,1972,0,0,4,4
2203,FRG,Rowing,1972,5,0,4,9
2204,FRG,Weightlifting,1972,0,1,0,1
2205,FRG,Wrestling,1972,0,1,1,2
2206,FRG,Boxing,1972,1,0,1,2
2207,FRG,Athletics,1972,9,3,8,20
2208,FRG,Judo,1972,0,1,1,2
2209,FRG,Swimming,1972,0,6,12,18
2210,FRG,Shooting,1972,1,0,0,1
2211,FRG,Equestrianism,1972,5,3,5,13
2212,FRG,Hockey,1972,18,0,0,18
2213,FRG,Cycling,1972,5,0,1,6
2214,FRG,Canoeing,1972,0,4,2,6
2215,FRG,Sailing,1976,4,0,2,6
2216,FRG,Rowing,1976,0,1,9,10
2217,FRG,Wrestling,1976,0,0,2,2
2218,FRG,Boxing,1976,0,0,1,1
2219,FRG,Athletics,1976,1,7,7,15
2220,FRG,Judo,1976,0,1,0,1
2221,FRG,Swimming,1976,0,0,7,7
2222,FRG,Fencing,1976,6,6,0,12
2223,FRG,Shooting,1976,1,1,1,3
2224,FRG,Equestrianism,1976,4,9,2,15
2225,FRG,Cycling,1976,5,0,0,5
2226,FRG,Gymnastics,1976,0,0,1,1
2227,FRG,Sailing,1984,0,2,0,2
2228,FRG,Rowing,1984,4,1,2,7
2229,FRG,Weightlifting,1984,2,0,1,3
2230,FRG,Wrestling,1984,1,2,0,3
2231,FRG,Boxing,1984,0,0,1,1
2232,FRG,Athletics,1984,4,2,10,16
2233,FRG,Judo,1984,1,0,2,3
2234,FRG,Swimming,1984,2,10,9,21
2235,FRG,Fencing,1984,10,7,0,17
2236,FRG,Shooting,1984,0,1,0,1
2237,FRG,Equestrianism,1984,4,0,8,12
2238,FRG,Hockey,1984,0,32,0,32
2239,FRG,Cycling,1984,1,2,5,8
2240,FRG,Canoeing,1984,1,1,2,4
2241,FRG,Water Polo,1984,0,0,12,12
2242,FRG,Handball,1984,0,15,0,15
2243,FRG,Rhythmic Gymnastics,1984,0,0,1,1
2244,FRG,Rowing,1988,9,1,4,14
2245,FRG,Tennis,1988,1,0,2,3
2246,FRG,Weightlifting,1988,0,1,2,3
2247,FRG,Wrestling,1988,0,1,0,1
2248,FRG,Boxing,1988,0,0,1,1
2249,FRG,Athletics,1988,0,1,8,9
2250,FRG,Judo,1988,0,2,0,2
2251,FRG,Swimming,1988,1,1,6,8
2252,FRG,Fencing,1988,7,11,1,19
2253,FRG,Football,1988,0,0,18,18
2254,FRG,Shooting,1988,1,1,1,3
2255,FRG,Equestrianism,1988,13,0,1,14
2256,FRG,Hockey,1988,0,16,0,16
2257,FRG,Cycling,1988,0,2,2,4
2258,GAB,Taekwondo,2012,0,1,0,1
2259,GBR,Tennis,1896,2,0,1,3
2260,GBR,Weightlifting,1896,1,1,0,2
2261,GBR,Athletics,1896,0,1,1,2
2262,GBR,Cycling,1896,0,1,1,2
2263,GBR,Sailing,1900,12,1,1,14
2264,GBR,Rowing,1900,0,0,1,1
2265,GBR,Tennis,1900,6,2,6,14
2266,GBR,Athletics,1900,7,3,2,12
2267,GBR,Rugby,1900,0,15,0,15
2268,GBR,Swimming,1900,2,0,1,3
2269,GBR,Polo,1900,3,2,1,6
2270,GBR,Football,1900,11,0,1,12
2271,GBR,Cycling,1900,0,1,0,1
2272,GBR,Water Polo,1900,6,0,1,7
2273,GBR,Golf,1900,0,1,1,2
2274,GBR,Cricket,1900,12,9,0,21
2275,GBR,Athletics,1904,1,1,0,2
2276,GBR,Athletics,1906,3,5,1,9
2277,GBR,Swimming,1906,1,2,5,8
2278,GBR,Fencing,1906,0,4,0,4
2279,GBR,Football,1906,0,8,0,8
2280,GBR,Shooting,1906,2,0,2,4
2281,GBR,Cycling,1906,3,3,0,6
2282,GBR,Sailing,1908,22,10,5,37
2283,GBR,Rowing,1908,16,7,9,32
2284,GBR,Tennis,1908,8,7,5,20
2285,GBR,Wrestling,1908,3,4,4,11
2286,GBR,Boxing,1908,5,4,5,14
2287,GBR,Athletics,1908,11,7,3,21
2288,GBR,Rugby,1908,0,15,0,15
2289,GBR,Swimming,1908,7,2,1,10
2290,GBR,Polo,1908,4,8,0,12
2291,GBR,Fencing,1908,0,6,0,6
2292,GBR,Football,1908,11,0,0,11
2293,GBR,Shooting,1908,14,15,16,45
2294,GBR,Hockey,1908,11,12,22,45
2295,GBR,Cycling,1908,8,4,2,14
2296,GBR,Archery,1908,2,2,1,5
2297,GBR,Water Polo,1908,7,0,0,7
2298,GBR,Gymnastics,1908,0,1,0,1
2299,GBR,Tug-Of-War,1908,8,8,8,24
2300,GBR,Lacrosse,1908,0,12,0,12
2301,GBR,Figure Skating,1908,1,3,4,8
2302,GBR,Motorboating,1908,6,0,0,6
2303,GBR,Jeu De Paume,1908,0,1,1,2
2304,GBR,Racquets,1908,3,3,4,10
2305,GBR,Rowing,1912,10,14,0,24
2306,GBR,Tennis,1912,3,3,3,9
2307,GBR,Athletics,1912,5,1,16,22
2308,GBR,Swimming,1912,4,2,6,12
2309,GBR,Fencing,1912,0,6,0,6
2310,GBR,Football,1912,14,0,0,14
2311,GBR,Shooting,1912,4,17,10,31
2312,GBR,Cycling,1912,0,13,0,13
2313,GBR,Diving,1912,0,0,1,1
2314,GBR,Water Polo,1912,7,0,0,7
2315,GBR,Gymnastics,1912,0,0,23,23
2316,GBR,Tug-Of-War,1912,0,8,0,8
2317,GBR,Sailing,1920,4,0,0,4
2318,GBR,Rowing,1920,0,10,0,10
2319,GBR,Tennis,1920,4,5,1,10
2320,GBR,Wrestling,1920,0,0,2,2
2321,GBR,Boxing,1920,2,1,3,6
2322,GBR,Athletics,1920,7,14,4,25
2323,GBR,Swimming,1920,0,4,4,8
2324,GBR,Polo,1920,4,0,0,4
2325,GBR,Hockey,1920,14,0,0,14
2326,GBR,Cycling,1920,2,6,1,9
2327,GBR,Diving,1920,0,1,0,1
2328,GBR,Water Polo,1920,7,0,0,7
2329,GBR,Art Competitions,1920,0,1,0,1
2330,GBR,Tug-Of-War,1920,8,0,0,8
2331,GBR,Figure Skating,1920,0,0,2,2
2332,GBR,Sailing,1924,0,5,0,5
2333,GBR,Rowing,1924,5,0,0,5
2334,GBR,Tennis,1924,0,2,3,5
2335,GBR,Wrestling,1924,0,0,1,1
2336,GBR,Boxing,1924,2,2,0,4
2337,GBR,Athletics,1924,3,11,8,22
2338,GBR,Swimming,1924,1,5,1,7
2339,GBR,Polo,1924,0,0,4,4
2340,GBR,Fencing,1924,0,1,0,1
2341,GBR,Shooting,1924,4,2,0,6
2342,GBR,Cycling,1924,0,1,1,2
2343,GBR,Diving,1924,0,0,1,1
2344,GBR,Art Competitions,1924,0,1,0,1
2345,GBR,Rowing,1928,4,11,1,16
2346,GBR,Wrestling,1928,0,0,1,1
2347,GBR,Athletics,1928,2,2,4,8
2348,GBR,Swimming,1928,0,5,2,7
2349,GBR,Fencing,1928,0,1,0,1
2350,GBR,Cycling,1928,0,7,4,11
2351,GBR,Gymnastics,1928,0,0,12,12
2352,GBR,Art Competitions,1928,1,1,0,2
2353,GBR,Sailing,1932,0,2,0,2
2354,GBR,Rowing,1932,6,0,0,6
2355,GBR,Athletics,1932,2,7,5,14
2356,GBR,Swimming,1932,0,0,5,5
2357,GBR,Fencing,1932,0,1,0,1
2358,GBR,Cycling,1932,0,2,4,6
2359,GBR,Art Competitions,1932,1,0,0,1
2360,GBR,Sailing,1936,5,0,1,6
2361,GBR,Rowing,1936,2,4,0,6
2362,GBR,Athletics,1936,5,8,0,13
2363,GBR,Polo,1936,0,4,0,4
2364,GBR,Equestrianism,1936,0,0,3,3
2365,GBR,Cycling,1936,0,0,4,4
2366,GBR,Sailing,1948,2,0,0,2
2367,GBR,Rowing,1948,4,9,0,13
2368,GBR,Weightlifting,1948,0,1,1,2
2369,GBR,Boxing,1948,0,2,0,2
2370,GBR,Athletics,1948,0,9,1,10
2371,GBR,Swimming,1948,0,0,1,1
2372,GBR,Equestrianism,1948,0,0,3,3
2373,GBR,Hockey,1948,0,12,0,12
2374,GBR,Cycling,1948,0,7,5,12
2375,GBR,Art Competitions,1948,1,2,1,4
2376,GBR,Sailing,1952,0,1,0,1
2377,GBR,Wrestling,1952,0,0,1,1
2378,GBR,Athletics,1952,0,1,7,8
2379,GBR,Swimming,1952,0,0,1,1
2380,GBR,Equestrianism,1952,3,0,0,3
2381,GBR,Hockey,1952,0,0,13,13
2382,GBR,Cycling,1952,0,0,4,4
2383,GBR,Sailing,1956,0,4,5,9
2384,GBR,Boxing,1956,2,1,2,5
2385,GBR,Athletics,1956,1,7,5,13
2386,GBR,Swimming,1956,1,0,1,2
2387,GBR,Fencing,1956,1,0,0,1
2388,GBR,Equestrianism,1956,3,0,4,7
2389,GBR,Cycling,1956,0,4,5,9
2390,GBR,Weightlifting,1960,0,0,1,1
2391,GBR,Boxing,1960,0,0,3,3
2392,GBR,Athletics,1960,1,3,7,11
2393,GBR,Swimming,1960,1,1,1,3
2394,GBR,Fencing,1960,0,7,0,7
2395,GBR,Equestrianism,1960,0,0,1,1
2396,GBR,Diving,1960,0,0,2,2
2397,GBR,Sailing,1964,0,2,0,2
2398,GBR,Rowing,1964,0,4,0,4
2399,GBR,Weightlifting,1964,0,1,0,1
2400,GBR,Athletics,1964,4,10,4,18
2401,GBR,Swimming,1964,0,1,0,1
2402,GBR,Fencing,1964,0,1,0,1
2403,GBR,Equestrianism,1964,0,0,1,1
2404,GBR,Sailing,1968,2,0,3,5
2405,GBR,Boxing,1968,1,0,0,1
2406,GBR,Athletics,1968,1,2,1,4
2407,GBR,Swimming,1968,0,1,0,1
2408,GBR,Shooting,1968,1,0,0,1
2409,GBR,Equestrianism,1968,4,2,1,7
2410,GBR,Sailing,1972,2,2,0,4
2411,GBR,Boxing,1972,0,0,3,3
2412,GBR,Athletics,1972,1,4,2,7
2413,GBR,Judo,1972,0,1,2,3
2414,GBR,Swimming,1972,0,1,0,1
2415,GBR,Shooting,1972,0,0,1,1
2416,GBR,Equestrianism,1972,5,1,0,6
2417,GBR,Cycling,1972,0,0,4,4
2418,GBR,Sailing,1976,2,2,0,4
2419,GBR,Rowing,1976,0,11,0,11
2420,GBR,Boxing,1976,0,0,1,1
2421,GBR,Athletics,1976,0,0,1,1
2422,GBR,Judo,1976,0,1,1,2
2423,GBR,Swimming,1976,1,1,4,6
2424,GBR,Cycling,1976,0,0,4,4
2425,GBR,Modern Pentathlon,1976,3,0,0,3
2426,GBR,Rowing,1980,0,9,6,15
2427,GBR,Boxing,1980,0,0,1,1
2428,GBR,Athletics,1980,4,2,10,16
2429,GBR,Judo,1980,0,1,1,2
2430,GBR,Swimming,1980,1,6,6,13
2431,GBR,Sailing,1984,0,0,2,2
2432,GBR,Rowing,1984,5,0,0,5
2433,GBR,Weightlifting,1984,0,0,1,1
2434,GBR,Wrestling,1984,0,0,1,1
2435,GBR,Boxing,1984,0,0,1,1
2436,GBR,Athletics,1984,3,10,9,22
2437,GBR,Judo,1984,0,1,2,3
2438,GBR,Swimming,1984,0,1,7,8
2439,GBR,Shooting,1984,1,0,3,4
2440,GBR,Equestrianism,1984,0,8,1,9
2441,GBR,Hockey,1984,0,0,15,15
2442,GBR,Sailing,1988,2,0,0,2
2443,GBR,Rowing,1988,2,0,3,5
2444,GBR,Boxing,1988,0,0,1,1
2445,GBR,Athletics,1988,0,10,2,12
2446,GBR,Judo,1988,0,0,1,1
2447,GBR,Swimming,1988,1,1,1,3
2448,GBR,Shooting,1988,1,1,0,2
2449,GBR,Equestrianism,1988,0,5,1,6
2450,GBR,Hockey,1988,16,0,0,16
2451,GBR,Archery,1988,0,0,3,3
2452,GBR,Modern Pentathlon,1988,0,0,3,3
2453,GBR,Sailing,1992,0,0,3,3
2454,GBR,Rowing,1992,5,0,0,5
2455,GBR,Boxing,1992,0,0,1,1
2456,GBR,Athletics,1992,2,0,12,14
2457,GBR,Judo,1992,0,2,2,4
2458,GBR,Swimming,1992,0,0,1,1
2459,GBR,Hockey,1992,0,0,16,16
2460,GBR,Cycling,1992,1,0,0,1
2461,GBR,Canoeing,1992,0,1,0,1
2462,GBR,Archery,1992,0,0,4,4
2463,GBR,Sailing,1996,0,3,0,3
2464,GBR,Rowing,1996,2,0,4,6
2465,GBR,Tennis,1996,0,2,0,2
2466,GBR,Athletics,1996,0,9,2,11
2467,GBR,Swimming,1996,0,1,1,2
2468,GBR,Cycling,1996,0,0,2,2
2469,GBR,Sailing,2000,3,4,0,7
2470,GBR,Rowing,2000,13,4,0,17
2471,GBR,Boxing,2000,1,0,0,1
2472,GBR,Athletics,2000,2,2,2,6
2473,GBR,Judo,2000,0,1,0,1
2474,GBR,Shooting,2000,1,1,0,2
2475,GBR,Equestrianism,2000,0,4,0,4
2476,GBR,Cycling,2000,1,3,6,10
2477,GBR,Canoeing,2000,0,1,1,2
2478,GBR,Modern Pentathlon,2000,1,0,1,2
2479,GBR,Badminton,2000,0,0,2,2
2480,GBR,Sailing,2004,4,2,3,9
2481,GBR,Rowing,2004,4,6,2,12
2482,GBR,Boxing,2004,0,1,0,1
2483,GBR,Athletics,2004,6,0,1,7
2484,GBR,Swimming,2004,0,0,2,2
2485,GBR,Equestrianism,2004,1,5,1,7
2486,GBR,Cycling,2004,2,6,2,10
2487,GBR,Diving,2004,0,2,0,2
2488,GBR,Canoeing,2004,0,1,2,3
2489,GBR,Archery,2004,0,0,1,1
2490,GBR,Modern Pentathlon,2004,0,0,1,1
2491,GBR,Badminton,2004,0,2,0,2
2492,GBR,Taekwondo,2008,0,0,1,1
2493,GBR,Sailing,2008,7,2,1,10
2494,GBR,Rowing,2008,6,13,4,23
2495,GBR,Boxing,2008,1,0,2,3
2496,GBR,Athletics,2008,1,2,5,8
2497,GBR,Swimming,2008,2,2,2,6
2498,GBR,Equestrianism,2008,0,0,6,6
2499,GBR,Cycling,2008,13,4,2,19
2500,GBR,Canoeing,2008,1,1,1,3
2501,GBR,Modern Pentathlon,2008,0,1,0,1
2502,GBR,Gymnastics,2008,0,0,1,1
2503,GBR,Taekwondo,2012,1,0,1,2
2504,GBR,Sailing,2012,1,7,0,8
2505,GBR,Rowing,2012,10,6,12,28
2506,GBR,Tennis,2012,1,2,0,3
2507,GBR,Boxing,2012,3,1,1,5
2508,GBR,Athletics,2012,4,1,1,6
2509,GBR,Judo,2012,0,1,1,2
2510,GBR,Swimming,2012,0,1,2,3
2511,GBR,Shooting,2012,1,0,0,1
2512,GBR,Equestrianism,2012,8,5,1,14
2513,GBR,Hockey,2012,0,0,16,16
2514,GBR,Cycling,2012,15,2,2,19
2515,GBR,Diving,2012,0,0,1,1
2516,GBR,Canoeing,2012,3,2,2,7
2517,GBR,Triathlon,2012,1,0,1,2
2518,GBR,Modern Pentathlon,2012,0,1,0,1
2519,GBR,Gymnastics,2012,0,1,7,8
2520,GBR,Taekwondo,2016,1,1,1,3
2521,GBR,Sailing,2016,3,1,0,4
2522,GBR,Rowing,2016,15,11,0,26
2523,GBR,Tennis,2016,1,0,0,1
2524,GBR,Boxing,2016,1,1,1,3
2525,GBR,Athletics,2016,2,1,11,14
2526,GBR,Judo,2016,0,0,1,1
2527,GBR,Swimming,2016,1,12,0,13
2528,GBR,Shooting,2016,0,0,2,2
2529,GBR,Equestrianism,2016,2,4,0,6
2530,GBR,Hockey,2016,16,0,0,16
2531,GBR,Cycling,2016,14,4,2,20
2532,GBR,Rugby Sevens,2016,0,12,0,12
2533,GBR,Diving,2016,2,1,2,5
2534,GBR,Canoeing,2016,2,4,0,6
2535,GBR,Trampolining,2016,0,1,0,1
2536,GBR,Triathlon,2016,1,1,1,3
2537,GBR,Gymnastics,2016,2,1,3,6
2538,GBR,Golf,2016,1,0,0,1
2539,GBR,Badminton,2016,0,0,2,2
2540,GBR,Taekwondo,2020,0,2,1,3
2541,GBR,Sailing,2020,5,2,1,8
2542,GBR,Rowing,2020,0,4,9,13
2543,GBR,Trampoline Gymnastics,2020,0,0,1,1
2544,GBR,Weightlifting,2020,0,1,0,1
2545,GBR,Boxing,2020,2,2,2,6
2546,GBR,Athletics,2020,0,8,7,15
2547,GBR,Judo,2020,0,0,1,1
2548,GBR,Artistic Gymnastics,2020,1,0,4,5
2549,GBR,Swimming,2020,12,7,1,20
2550,GBR,Shooting,2020,0,0,1,1
2551,GBR,Hockey,2020,0,0,18,18
2552,GBR,Cycling BMX Freestyle,2020,1,0,1,2
2553,GBR,Diving,2020,2,0,2,4
2554,GBR,Triathlon,2020,5,2,0,7
2555,GBR,Modern Pentathlon,2020,2,0,0,2
2556,GBR,Canoe Slalom,2020,0,1,0,1
2557,GBR,Canoe Sprint,2020,0,0,1,1
2558,GBR,Cycling Track,2020,4,12,1,17
2559,GBR,Equestrian,2020,5,1,5,11
2560,GBR,Skateboarding,2020,0,0,1,1
2561,GBR,Cycling BMX Racing,2020,1,1,0,2
2562,GBR,Cycling Mountain Bike,2020,1,0,0,1
2563,GBR,Taekwondo,2024,0,1,0,1
2564,GBR,Sailing,2024,1,0,1,2
2565,GBR,Rowing,2024,15,6,15,36
2566,GBR,Trampoline Gymnastics,2024,1,0,0,1
2567,GBR,Weightlifting,2024,0,0,1,1
2568,GBR,Boxing,2024,0,0,1,1
2569,GBR,Athletics,2024,1,9,30,40
2570,GBR,Artistic Gymnastics,2024,0,0,2,2
2571,GBR,Swimming,2024,6,4,0,10
2572,GBR,Shooting,2024,1,1,0,2
2573,GBR,Cycling BMX Freestyle,2024,0,1,0,1
2574,GBR,Diving,2024,0,2,7,9
2575,GBR,Triathlon,2024,1,0,1,2
2576,GBR,Canoe Slalom,2024,0,2,2,4
2577,GBR,Cycling Road,2024,0,1,0,1
2578,GBR,Cycling Track,2024,4,11,9,24
2579,GBR,Equestrian,2024,8,0,6,14
2580,GBR,Skateboarding,2024,0,0,1,1
2581,GBR,Sport Climbing,2024,1,0,0,1
2582,GBR,Golf,2024,0,1,0,1
2583,GBR,Artistic Swimming,2024,0,2,0,2
2584,GDR,Sailing,1968,0,0,3,3
2585,GDR,Rowing,1968,6,5,0,11
2586,GDR,Wrestling,1968,2,0,0,2
2587,GDR,Boxing,1968,1,0,0,1
2588,GDR,Athletics,1968,2,3,1,6
2589,GDR,Swimming,1968,2,10,1,13
2590,GDR,Shooting,1968,0,0,2,2
2591,GDR,Gymnastics,1968,0,2,12,14
2592,GDR,Sailing,1972,0,3,0,3
2593,GDR,Rowing,1972,9,5,12,26
2594,GDR,Weightlifting,1972,0,0,2,2
2595,GDR,Wrestling,1972,0,1,0,1
2596,GDR,Boxing,1972,0,0,1,1
2597,GDR,Athletics,1972,11,10,5,26
2598,GDR,Judo,1972,0,0,1,1
2599,GDR,Swimming,1972,2,16,6,24
2600,GDR,Football,1972,0,0,17,17
2601,GDR,Shooting,1972,0,0,2,2
2602,GDR,Volleyball,1972,0,12,0,12
2603,GDR,Cycling,1972,0,6,1,7
2604,GDR,Diving,1972,0,0,2,2
2605,GDR,Canoeing,1972,5,2,1,8
2606,GDR,Gymnastics,1972,3,9,7,19
2607,GDR,Sailing,1976,1,0,3,4
2608,GDR,Rowing,1976,42,9,3,54
2609,GDR,Weightlifting,1976,0,1,2,3
2610,GDR,Wrestling,1976,0,1,1,2
2611,GDR,Boxing,1976,1,1,0,2
2612,GDR,Athletics,1976,17,10,9,36
2613,GDR,Swimming,1976,17,9,2,28
2614,GDR,Football,1976,17,0,0,17
2615,GDR,Shooting,1976,2,2,0,4
2616,GDR,Cycling,1976,1,0,2,3
2617,GDR,Diving,1976,0,1,0,1
2618,GDR,Canoeing,1976,4,2,7,13
2619,GDR,Gymnastics,1976,0,1,13,14
2620,GDR,Handball,1976,0,14,0,14
2621,GDR,Sailing,1980,0,2,0,2
2622,GDR,Rowing,1980,51,2,2,55
2623,GDR,Weightlifting,1980,0,2,1,3
2624,GDR,Wrestling,1980,0,1,0,1
2625,GDR,Boxing,1980,1,0,5,6
2626,GDR,Athletics,1980,14,14,10,38
2627,GDR,Judo,1980,1,0,4,5
2628,GDR,Swimming,1980,20,14,8,42
2629,GDR,Football,1980,0,17,0,17
2630,GDR,Shooting,1980,0,5,1,6
2631,GDR,Volleyball,1980,0,12,0,12
2632,GDR,Cycling,1980,2,8,0,10
2633,GDR,Diving,1980,2,1,1,4
2634,GDR,Canoeing,1980,8,2,4,14
2635,GDR,Gymnastics,1980,2,8,11,21
2636,GDR,Handball,1980,14,0,14,28
2637,GDR,Sailing,1988,3,0,0,3
2638,GDR,Rowing,1988,31,3,4,38
2639,GDR,Weightlifting,1988,1,1,1,3
2640,GDR,Wrestling,1988,0,0,1,1
2641,GDR,Boxing,1988,2,1,0,3
2642,GDR,Athletics,1988,6,14,14,34
2643,GDR,Judo,1988,0,2,1,3
2644,GDR,Swimming,1988,21,12,12,45
2645,GDR,Fencing,1988,0,1,0,1
2646,GDR,Shooting,1988,1,1,0,2
2647,GDR,Cycling,1988,6,6,1,13
2648,GDR,Canoeing,1988,7,5,5,17
2649,GDR,Gymnastics,1988,1,8,9,18
2650,GEO,Wrestling,1996,0,0,1,1
2651,GEO,Judo,1996,0,0,1,1
2652,GEO,Weightlifting,2000,0,0,1,1
2653,GEO,Wrestling,2000,0,0,3,3
2654,GEO,Boxing,2000,0,0,1,1
2655,GEO,Judo,2000,0,0,1,1
2656,GEO,Weightlifting,2004,1,0,0,1
2657,GEO,Wrestling,2004,0,1,0,1
2658,GEO,Judo,2004,1,1,0,2
2659,GEO,Wrestling,2008,2,0,2,4
2660,GEO,Judo,2008,1,0,0,1
2661,GEO,Shooting,2008,0,0,1,1
2662,GEO,Wrestling,2012,0,3,3,6
2663,GEO,Judo,2012,1,0,0,1
2664,GEO,Weightlifting,2016,1,0,1,2
2665,GEO,Wrestling,2016,1,0,2,3
2666,GEO,Judo,2016,0,1,1,2
2667,GEO,Weightlifting,2020,1,0,1,2
2668,GEO,Wrestling,2020,0,2,0,2
2669,GEO,Judo,2020,1,3,0,4
2670,GEO,Weightlifting,2024,1,0,0,1
2671,GEO,Wrestling,2024,1,1,0,2
2672,GEO,Boxing,2024,0,0,1,1
2673,GEO,Judo,2024,1,2,0,3
2674,GER,Tennis,1896,1,0,0,1
2675,GER,Wrestling,1896,1,0,0,1
2676,GER,Athletics,1896,0,1,0,1
2677,GER,Cycling,1896,0,1,0,1
2678,GER,Gymnastics,1896,23,3,2,28
2679,GER,Sailing,1900,4,4,0,8
2680,GER,Rowing,1900,5,0,11,16
2681,GER,Rugby,1900,0,15,0,15
2682,GER,Swimming,1900,5,0,0,5
2683,GER,Cycling,1900,0,1,0,1
2684,GER,Weightlifting,1904,0,0,2,2
2685,GER,Wrestling,1904,0,1,0,1
2686,GER,Athletics,1904,0,0,1,1
2687,GER,Swimming,1904,4,2,2,8
2688,GER,Diving,1904,0,1,0,1
2689,GER,Gymnastics,1904,0,1,1,2
2690,GER,Tug-Of-War,1904,0,0,1,1
2691,GER,Weightlifting,1906,0,0,3,3
2692,GER,Athletics,1906,0,1,1,2
2693,GER,Swimming,1906,0,4,0,4
2694,GER,Fencing,1906,5,2,0,7
2695,GER,Cycling,1906,0,2,2,4
2696,GER,Diving,1906,1,1,0,2
2697,GER,Tug-Of-War,1906,8,0,0,8
2698,GER,Rowing,1908,0,0,3,3
2699,GER,Tennis,1908,0,1,0,1
2700,GER,Athletics,1908,0,4,1,5
2701,GER,Swimming,1908,1,0,0,1
2702,GER,Cycling,1908,0,4,1,5
2703,GER,Diving,1908,1,1,1,3
2704,GER,Figure Skating,1908,2,1,0,3
2705,GER,Rowing,1912,5,0,9,14
2706,GER,Tennis,1912,2,1,1,4
2707,GER,Wrestling,1912,0,1,0,1
2708,GER,Athletics,1912,0,2,0,2
2709,GER,Swimming,1912,2,6,2,10
2710,GER,Shooting,1912,0,1,6,7
2711,GER,Equestrianism,1912,0,6,4,10
2712,GER,Diving,1912,1,2,1,4
2713,GER,Art Competitions,1912,1,0,0,1
2714,GER,Rowing,1928,2,0,0,2
2715,GER,Weightlifting,1928,2,0,1,3
2716,GER,Wrestling,1928,1,2,1,4
2717,GER,Boxing,1928,0,1,0,1
2718,GER,Athletics,1928,1,8,9,18
2719,GER,Swimming,1928,1,1,1,3
2720,GER,Fencing,1928,1,1,1,3
2721,GER,Equestrianism,1928,4,0,1,5
2722,GER,Hockey,1928,0,0,19,19
2723,GER,Cycling,1928,0,0,2,2
2724,GER,Water Polo,1928,8,0,0,8
2725,GER,Modern Pentathlon,1928,0,0,1,1
2726,GER,Art Competitions,1928,1,2,5,8
2727,GER,Rowing,1932,5,6,0,11
2728,GER,Weightlifting,1932,1,1,1,3
2729,GER,Wrestling,1932,1,2,1,4
2730,GER,Boxing,1932,0,3,0,3
2731,GER,Athletics,1932,0,5,3,8
2732,GER,Shooting,1932,0,1,0,1
2733,GER,Water Polo,1932,0,8,0,8
2734,GER,Art Competitions,1932,1,0,2,3
2735,GER,Alpinism,1932,2,0,0,2
2736,GER,Sailing,1936,2,1,6,9
2737,GER,Rowing,1936,15,2,9,26
2738,GER,Weightlifting,1936,1,2,2,5
2739,GER,Wrestling,1936,0,3,4,7
2740,GER,Boxing,1936,2,2,1,5
2741,GER,Athletics,1936,5,4,13,22
2742,GER,Swimming,1936,0,7,1,8
2743,GER,Fencing,1936,0,1,12,13
2744,GER,Shooting,1936,1,2,0,3
2745,GER,Equestrianism,1936,12,1,0,13
2746,GER,Hockey,1936,0,22,0,22
2747,GER,Cycling,1936,3,0,1,4
2748,GER,Diving,1936,0,0,2,2
2749,GER,Canoeing,1936,3,5,2,10
2750,GER,Water Polo,1936,0,11,0,11
2751,GER,Modern Pentathlon,1936,1,0,0,1
2752,GER,Gymnastics,1936,20,1,6,27
2753,GER,Art Competitions,1936,6,6,2,14
2754,GER,Handball,1936,22,0,0,22
2755,GER,Sailing,1952,0,0,3,3
2756,GER,Rowing,1952,0,3,0,3
2757,GER,Boxing,1952,0,1,1,2
2758,GER,Athletics,1952,0,6,8,14
2759,GER,Swimming,1952,0,0,1,1
2760,GER,Equestrianism,1952,0,3,5,8
2761,GER,Cycling,1952,0,0,2,2
2762,GER,Diving,1952,0,0,1,1
2763,GER,Canoeing,1952,0,0,5,5
2764,GER,Gymnastics,1952,0,1,0,1
2765,GER,Rowing,1956,0,3,0,3
2766,GER,Wrestling,1956,0,1,0,1
2767,GER,Boxing,1956,1,1,0,2
2768,GER,Athletics,1956,0,5,5,10
2769,GER,Swimming,1956,1,0,1,2
2770,GER,Equestrianism,1956,4,7,1,12
2771,GER,Hockey,1956,0,0,11,11
2772,GER,Cycling,1956,0,0,4,4
2773,GER,Canoeing,1956,2,3,1,6
2774,GER,Gymnastics,1956,1,0,0,1
2775,GER,Sailing,1960,0,0,3,3
2776,GER,Rowing,1960,17,1,0,18
2777,GER,Wrestling,1960,1,3,0,4
2778,GER,Boxing,1960,0,0,1,1
2779,GER,Athletics,1960,5,14,3,22
2780,GER,Swimming,1960,0,1,9,10
2781,GER,Fencing,1960,1,0,4,5
2782,GER,Shooting,1960,1,0,1,2
2783,GER,Equestrianism,1960,3,0,1,4
2784,GER,Cycling,1960,0,11,0,11
2785,GER,Diving,1960,2,0,0,2
2786,GER,Canoeing,1960,4,3,0,7
2787,GER,Sailing,1964,1,3,0,4
2788,GER,Rowing,1964,5,10,2,17
2789,GER,Wrestling,1964,0,1,3,4
2790,GER,Boxing,1964,0,2,1,3
2791,GER,Athletics,1964,2,5,3,10
2792,GER,Judo,1964,0,1,1,2
2793,GER,Swimming,1964,0,13,2,15
2794,GER,Fencing,1964,0,1,4,5
2795,GER,Football,1964,0,0,19,19
2796,GER,Equestrianism,1964,6,2,5,13
2797,GER,Cycling,1964,4,0,2,6
2798,GER,Diving,1964,1,1,0,2
2799,GER,Canoeing,1964,3,4,2,9
2800,GER,Gymnastics,1964,0,1,6,7
2801,GER,Rowing,1992,11,9,22,42
2802,GER,Tennis,1992,2,1,0,3
2803,GER,Weightlifting,1992,1,0,2,3
2804,GER,Wrestling,1992,1,2,0,3
2805,GER,Boxing,1992,2,1,1,4
2806,GER,Athletics,1992,4,1,5,10
2807,GER,Judo,1992,0,0,2,2
2808,GER,Swimming,1992,1,9,17,27
2809,GER,Fencing,1992,10,5,0,15
2810,GER,Shooting,1992,2,0,1,3
2811,GER,Equestrianism,1992,6,2,5,13
2812,GER,Hockey,1992,16,16,0,32
2813,GER,Cycling,1992,11,2,0,13
2814,GER,Diving,1992,0,0,1,1
2815,GER,Canoeing,1992,14,6,2,22
2816,GER,Gymnastics,1992,0,1,2,3
2817,GER,Table Tennis,1992,0,2,0,2
2818,GER,Sailing,1996,3,0,0,3
2819,GER,Rowing,1996,8,9,1,18
2820,GER,Tennis,1996,0,0,2,2
2821,GER,Weightlifting,1996,0,2,1,3
2822,GER,Wrestling,1996,0,1,2,3
2823,GER,Boxing,1996,0,1,3,4
2824,GER,Athletics,1996,3,1,6,10
2825,GER,Judo,1996,1,0,4,5
2826,GER,Swimming,1996,0,10,20,30
2827,GER,Fencing,1996,0,0,3,3
2828,GER,Shooting,1996,2,2,0,4
2829,GER,Equestrianism,1996,10,0,0,10
2830,GER,Cycling,1996,1,0,1,2
2831,GER,Diving,1996,0,2,0,2
2832,GER,Canoeing,1996,13,4,3,20
2833,GER,Archery,1996,0,3,0,3
2834,GER,Gymnastics,1996,1,0,0,1
2835,GER,Table Tennis,1996,0,0,1,1
2836,GER,Taekwondo,2000,0,1,0,1
2837,GER,Sailing,2000,0,4,2,6
2838,GER,Rowing,2000,6,2,6,14
2839,GER,Tennis,2000,0,1,0,1
2840,GER,Weightlifting,2000,0,2,0,2
2841,GER,Boxing,2000,0,0,1,1
2842,GER,Athletics,2000,2,1,2,5
2843,GER,Judo,2000,0,0,1,1
2844,GER,Swimming,2000,0,0,11,11
2845,GER,Fencing,2000,0,2,7,9
2846,GER,Football,2000,0,0,17,17
2847,GER,Equestrianism,2000,8,1,1,10
2848,GER,Cycling,2000,7,4,3,14
2849,GER,Diving,2000,0,0,3,3
2850,GER,Canoeing,2000,8,4,5,17
2851,GER,Beach Volleyball,2000,0,0,2,2
2852,GER,Archery,2000,0,0,3,3
2853,GER,Triathlon,2000,0,1,0,1
2854,GER,Rowing,2004,5,4,0,9
2855,GER,Tennis,2004,0,2,0,2
2856,GER,Boxing,2004,0,0,2,2
2857,GER,Athletics,2004,0,2,0,2
2858,GER,Judo,2004,1,0,3,4
2859,GER,Swimming,2004,0,5,12,17
2860,GER,Fencing,2004,0,3,3,6
2861,GER,Football,2004,0,0,17,17
2862,GER,Shooting,2004,2,1,0,3
2863,GER,Equestrianism,2004,4,1,4,9
2864,GER,Hockey,2004,16,0,16,32
2865,GER,Cycling,2004,3,1,4,8
2866,GER,Diving,2004,0,2,0,2
2867,GER,Canoeing,2004,9,9,1,19
2868,GER,Trampolining,2004,1,0,1,2
2869,GER,Handball,2004,0,15,0,15
2870,GER,Sailing,2008,0,0,2,2
2871,GER,Rowing,2008,0,2,4,6
2872,GER,Weightlifting,2008,1,0,0,1
2873,GER,Wrestling,2008,0,1,0,1
2874,GER,Athletics,2008,0,0,1,1
2875,GER,Judo,2008,1,0,0,1
2876,GER,Swimming,2008,2,0,1,3
2877,GER,Fencing,2008,2,0,0,2
2878,GER,Football,2008,0,0,16,16
2879,GER,Shooting,2008,0,1,3,4
2880,GER,Equestrianism,2008,9,1,1,11
2881,GER,Hockey,2008,17,0,0,17
2882,GER,Cycling,2008,1,1,3,5
2883,GER,Diving,2008,0,2,2,4
2884,GER,Canoeing,2008,7,4,7,18
2885,GER,Triathlon,2008,1,0,0,1
2886,GER,Modern Pentathlon,2008,1,0,0,1
2887,GER,Gymnastics,2008,0,1,1,2
2888,GER,Table Tennis,2008,0,3,0,3
2889,GER,Taekwondo,2012,0,0,1,1
2890,GER,Rowing,2012,13,4,0,17
2891,GER,Athletics,2012,1,4,3,8
2892,GER,Judo,2012,0,2,2,4
2893,GER,Swimming,2012,0,1,0,1
2894,GER,Fencing,2012,0,1,4,5
2895,GER,Equestrianism,2012,6,3,1,10
2896,GER,Hockey,2012,16,0,0,16
2897,GER,Cycling,2012,2,4,3,9
2898,GER,Canoeing,2012,5,5,4,14
2899,GER,Beach Volleyball,2012,2,0,0,2
2900,GER,Gymnastics,2012,0,3,0,3
2901,GER,Table Tennis,2012,0,0,4,4
2902,GER,Sailing,2016,0,0,2,2
2903,GER,Rowing,2016,8,9,0,17
2904,GER,Tennis,2016,0,1,0,1
2905,GER,Wrestling,2016,0,0,1,1
2906,GER,Boxing,2016,0,0,1,1
2907,GER,Athletics,2016,2,0,1,3
2908,GER,Judo,2016,0,0,1,1
2909,GER,Football,2016,18,17,0,35
2910,GER,Shooting,2016,3,1,0,4
2911,GER,Equestrianism,2016,5,5,5,15
2912,GER,Hockey,2016,0,0,33,33
2913,GER,Cycling,2016,1,0,2,3
2914,GER,Diving,2016,0,0,1,1
2915,GER,Canoeing,2016,9,6,1,16
2916,GER,Beach Volleyball,2016,2,0,0,2
2917,GER,Archery,2016,0,1,0,1
2918,GER,Gymnastics,2016,1,0,1,2
2919,GER,Handball,2016,0,0,15,15
2920,GER,Table Tennis,2016,0,3,3,6
2921,GER,Sailing,2020,0,2,4,6
2922,GER,Rowing,2020,0,11,0,11
2923,GER,Tennis,2020,1,0,0,1
2924,GER,Wrestling,2020,1,0,2,3
2925,GER,Athletics,2020,1,2,0,3
2926,GER,Judo,2020,0,1,13,14
2927,GER,Artistic Gymnastics,2020,0,1,0,1
2928,GER,Swimming,2020,0,0,2,2
2929,GER,Diving,2020,0,0,4,4
2930,GER,Archery,2020,0,0,3,3
2931,GER,Canoe Slalom,2020,1,0,3,4
2932,GER,Canoe Sprint,2020,4,2,2,8
2933,GER,Cycling Track,2020,6,3,0,9
2934,GER,Equestrian,2020,6,1,0,7
2935,GER,Marathon Swimming,2020,1,0,0,1
2936,GER,Table Tennis,2020,0,3,1,4
2937,GER,Rowing,2024,1,0,4,5
2938,GER,Boxing,2024,0,0,1,1
2939,GER,Athletics,2024,1,2,5,8
2940,GER,Judo,2024,0,1,0,1
2941,GER,Swimming,2024,1,0,1,2
2942,GER,Football,2024,0,0,20,20
2943,GER,Hockey,2024,0,18,0,18
2944,GER,Beach Volleyball,2024,0,2,0,2
2945,GER,Archery,2024,0,2,0,2
2946,GER,Canoe Slalom,2024,0,1,1,2
2947,GER,Canoe Sprint,2024,6,4,2,12
2948,GER,Cycling Track,2024,0,1,4,5
2949,GER,Equestrian,2024,7,1,0,8
2950,GER,Handball,2024,0,16,0,16
2951,GER,Rhythmic Gymnastics,2024,1,0,0,1
2952,GER,Golf,2024,0,1,0,1
2953,GER,3x3 Basketball,2024,4,0,0,4
2954,GHA,Boxing,1960,0,1,0,1
2955,GHA,Boxing,1964,0,0,1,1
2956,GHA,Boxing,1972,0,0,1,1
2957,GHA,Football,1992,0,0,20,20
2958,GHA,Boxing,2020,0,0,1,1
2959,GRE,Tennis,1896,0,3,1,4
2960,GRE,Weightlifting,1896,0,0,2,2
2961,GRE,Wrestling,1896,0,1,1,2
2962,GRE,Athletics,1896,1,3,6,10
2963,GRE,Swimming,1896,1,3,2,6
2964,GRE,Fencing,1896,2,1,2,5
2965,GRE,Shooting,1896,3,3,3,9
2966,GRE,Cycling,1896,1,3,0,4
2967,GRE,Gymnastics,1896,2,1,3,6
2968,GRE,Weightlifting,1904,1,0,0,1
2969,GRE,Athletics,1904,0,0,1,1
2970,GRE,Rowing,1906,17,25,7,49
2971,GRE,Tennis,1906,1,5,3,9
2972,GRE,Weightlifting,1906,1,0,0,1
2973,GRE,Athletics,1906,1,2,4,7
2974,GRE,Fencing,1906,1,5,1,7
2975,GRE,Football,1906,0,0,11,11
2976,GRE,Shooting,1906,2,3,3,8
2977,GRE,Gymnastics,1906,1,0,1,2
2978,GRE,Tug-Of-War,1906,0,8,0,8
2979,GRE,Athletics,1908,0,3,0,3
2980,GRE,Shooting,1908,0,0,1,1
2981,GRE,Athletics,1912,1,0,1,2
2982,GRE,Shooting,1920,0,5,0,5
2983,GRE,Art Competitions,1924,1,0,0,1
2984,GRE,Athletics,1956,0,0,1,1
2985,GRE,Sailing,1960,3,0,0,3
2986,GRE,Wrestling,1968,0,0,1,1
2987,GRE,Sailing,1972,0,1,0,1
2988,GRE,Wrestling,1972,0,1,0,1
2989,GRE,Sailing,1980,0,0,3,3
2990,GRE,Wrestling,1980,1,0,1,2
2991,GRE,Wrestling,1984,0,1,1,2
2992,GRE,Wrestling,1988,0,0,1,1
2993,GRE,Weightlifting,1992,1,0,0,1
2994,GRE,Athletics,1992,1,0,0,1
2995,GRE,Sailing,1996,1,0,0,1
2996,GRE,Weightlifting,1996,2,3,0,5
2997,GRE,Athletics,1996,0,1,0,1
2998,GRE,Gymnastics,1996,1,0,0,1
2999,GRE,Taekwondo,2000,1,0,0,1
3000,GRE,Weightlifting,2000,2,2,1,5
3001,GRE,Wrestling,2000,0,0,1,1
3002,GRE,Athletics,2000,1,3,0,4
3003,GRE,Gymnastics,2000,0,1,0,1
3004,GRE,Rhythmic Gymnastics,2000,0,0,6,6
3005,GRE,Taekwondo,2004,0,2,0,2
3006,GRE,Sailing,2004,2,1,0,3
3007,GRE,Rowing,2004,0,0,2,2
3008,GRE,Weightlifting,2004,0,0,1,1
3009,GRE,Wrestling,2004,0,0,1,1
3010,GRE,Athletics,2004,2,2,1,5
3011,GRE,Judo,2004,1,0,0,1
3012,GRE,Diving,2004,2,0,0,2
3013,GRE,Water Polo,2004,0,13,0,13
3014,GRE,Gymnastics,2004,1,0,0,1
3015,GRE,Taekwondo,2008,0,1,0,1
3016,GRE,Sailing,2008,0,0,3,3
3017,GRE,Rowing,2008,0,2,0,2
3018,GRE,Athletics,2008,0,0,1,1
3019,GRE,Rowing,2012,0,0,2,2
3020,GRE,Judo,2012,0,0,1,1
3021,GRE,Sailing,2016,0,0,2,2
3022,GRE,Athletics,2016,1,0,0,1
3023,GRE,Swimming,2016,0,1,0,1
3024,GRE,Shooting,2016,1,0,1,2
3025,GRE,Gymnastics,2016,1,0,0,1
3026,GRE,Rowing,2020,1,0,0,1
3027,GRE,Athletics,2020,1,0,0,1
3028,GRE,Artistic Gymnastics,2020,0,0,1,1
3029,GRE,Water Polo,2020,0,13,0,13
3030,GRE,Rowing,2024,0,0,4,4
3031,GRE,Wrestling,2024,0,0,1,1
3032,GRE,Athletics,2024,1,0,1,2
3033,GRE,Judo,2024,0,0,1,1
3034,GRE,Artistic Gymnastics,2024,0,0,1,1
3035,GRE,Swimming,2024,0,1,0,1
3036,GRN,Athletics,2012,1,0,0,1
3037,GRN,Athletics,2016,0,1,0,1
3038,GRN,Athletics,2020,0,0,1,1
3039,GRN,Athletics,2024,0,0,2,2
3040,GUA,Athletics,2012,0,1,0,1
3041,GUA,Shooting,2024,1,0,1,2
3042,GUY,Boxing,1980,0,0,1,1
3043,HAI,Rugby,1900,1,0,0,1
3044,HAI,Shooting,1924,0,0,5,5
3045,HAI,Athletics,1928,0,1,0,1
3046,HKG,Sailing,1996,1,0,0,1
3047,HKG,Table Tennis,2004,0,2,0,2
3048,HKG,Cycling,2012,0,0,1,1
3049,HKG,Swimming,2020,0,2,0,2
3050,HKG,Fencing,2020,1,0,0,1
3051,HKG,Cycling Track,2020,0,0,1,1
3052,HKG,Karate,2020,0,0,1,1
3053,HKG,Table Tennis,2020,0,0,3,3
3054,HKG,Swimming,2024,0,0,2,2
3055,HKG,Fencing,2024,2,0,0,2
3056,HUN,Tennis,1896,0,0,1,1
3057,HUN,Athletics,1896,0,1,2,3
3058,HUN,Swimming,1896,2,0,0,2
3059,HUN,Athletics,1900,1,0,1,2
3060,HUN,Swimming,1900,0,2,1,3
3061,HUN,Swimming,1904,2,1,1,4
3062,HUN,Wrestling,1906,0,0,1,1
3063,HUN,Athletics,1906,1,3,1,5
3064,HUN,Swimming,1906,4,1,0,5
3065,HUN,Fencing,1906,0,0,1,1
3066,HUN,Gymnastics,1906,0,1,0,1
3067,HUN,Rowing,1908,0,0,1,1
3068,HUN,Wrestling,1908,1,0,0,1
3069,HUN,Athletics,1908,0,1,5,6
3070,HUN,Swimming,1908,0,5,0,5
3071,HUN,Fencing,1908,6,1,0,7
3072,HUN,Wrestling,1912,0,0,1,1
3073,HUN,Athletics,1912,0,0,1,1
3074,HUN,Fencing,1912,9,1,1,11
3075,HUN,Shooting,1912,1,0,0,1
3076,HUN,Gymnastics,1912,0,16,0,16
3077,HUN,Wrestling,1924,0,1,1,2
3078,HUN,Athletics,1924,0,1,0,1
3079,HUN,Swimming,1924,0,0,1,1
3080,HUN,Fencing,1924,1,8,6,15
3081,HUN,Shooting,1924,1,0,0,1
3082,HUN,Art Competitions,1924,0,2,0,2
3083,HUN,Wrestling,1928,1,1,0,2
3084,HUN,Boxing,1928,1,0,0,1
3085,HUN,Athletics,1928,0,1,0,1
3086,HUN,Swimming,1928,0,1,0,1
3087,HUN,Fencing,1928,7,1,0,8
3088,HUN,Water Polo,1928,0,7,0,7
3089,HUN,Art Competitions,1928,1,0,0,1
3090,HUN,Wrestling,1932,0,2,1,3
3091,HUN,Boxing,1932,1,0,0,1
3092,HUN,Swimming,1932,0,0,4,4
3093,HUN,Fencing,1932,7,0,2,9
3094,HUN,Shooting,1932,0,0,1,1
3095,HUN,Water Polo,1932,10,0,0,10
3096,HUN,Gymnastics,1932,2,2,0,4
3097,HUN,Art Competitions,1932,0,1,0,1
3098,HUN,Wrestling,1936,3,0,1,4
3099,HUN,Boxing,1936,1,0,0,1
3100,HUN,Athletics,1936,1,0,0,1
3101,HUN,Swimming,1936,1,0,4,5
3102,HUN,Fencing,1936,8,0,1,9
3103,HUN,Shooting,1936,0,1,0,1
3104,HUN,Equestrianism,1936,0,0,1,1
3105,HUN,Water Polo,1936,11,0,0,11
3106,HUN,Gymnastics,1936,0,0,8,8
3107,HUN,Rowing,1948,0,0,3,3
3108,HUN,Wrestling,1948,1,1,2,4
3109,HUN,Boxing,1948,2,0,0,2
3110,HUN,Athletics,1948,2,0,1,3
3111,HUN,Swimming,1948,0,4,3,7
3112,HUN,Fencing,1948,8,0,2,10
3113,HUN,Shooting,1948,1,0,0,1
3114,HUN,Water Polo,1948,0,11,0,11
3115,HUN,Gymnastics,1948,1,9,10,20
3116,HUN,Art Competitions,1948,0,0,1,1
3117,HUN,Wrestling,1952,2,1,1,4
3118,HUN,Boxing,1952,1,0,0,1
3119,HUN,Athletics,1952,1,0,7,8
3120,HUN,Swimming,1952,8,2,1,11
3121,HUN,Fencing,1952,7,2,7,16
3122,HUN,Football,1952,15,0,0,15
3123,HUN,Shooting,1952,1,1,1,3
3124,HUN,Canoeing,1952,0,2,2,4
3125,HUN,Water Polo,1952,13,0,0,13
3126,HUN,Modern Pentathlon,1952,3,1,1,5
3127,HUN,Gymnastics,1952,2,8,12,22
3128,HUN,Wrestling,1956,0,1,1,2
3129,HUN,Boxing,1956,1,0,0,1
3130,HUN,Athletics,1956,0,2,0,2
3131,HUN,Swimming,1956,0,1,1,2
3132,HUN,Fencing,1956,7,6,6,19
3133,HUN,Canoeing,1956,2,3,5,10
3134,HUN,Water Polo,1956,11,0,0,11
3135,HUN,Gymnastics,1956,9,7,1,17
3136,HUN,Weightlifting,1960,0,0,1,1
3137,HUN,Wrestling,1960,0,1,0,1
3138,HUN,Boxing,1960,1,0,0,1
3139,HUN,Athletics,1960,0,1,2,3
3140,HUN,Fencing,1960,7,6,0,13
3141,HUN,Football,1960,0,0,16,16
3142,HUN,Canoeing,1960,1,7,4,12
3143,HUN,Water Polo,1960,0,0,14,14
3144,HUN,Modern Pentathlon,1960,4,1,0,5
3145,HUN,Weightlifting,1964,0,2,1,3
3146,HUN,Wrestling,1964,2,0,0,2
3147,HUN,Athletics,1964,0,3,1,4
3148,HUN,Fencing,1964,12,0,0,12
3149,HUN,Football,1964,14,0,0,14
3150,HUN,Shooting,1964,1,0,1,2
3151,HUN,Canoeing,1964,0,1,0,1
3152,HUN,Water Polo,1964,12,0,0,12
3153,HUN,Modern Pentathlon,1964,1,0,3,4
3154,HUN,Gymnastics,1964,0,1,1,2
3155,HUN,Rowing,1968,0,4,0,4
3156,HUN,Weightlifting,1968,0,1,1,2
3157,HUN,Wrestling,1968,2,0,2,4
3158,HUN,Athletics,1968,2,1,4,7
3159,HUN,Fencing,1968,6,6,7,19
3160,HUN,Football,1968,17,0,0,17
3161,HUN,Shooting,1968,0,1,0,1
3162,HUN,Canoeing,1968,2,6,4,12
3163,HUN,Water Polo,1968,0,0,11,11
3164,HUN,Modern Pentathlon,1968,3,1,0,4
3165,HUN,Weightlifting,1972,1,1,3,5
3166,HUN,Wrestling,1972,1,0,4,5
3167,HUN,Boxing,1972,1,2,1,4
3168,HUN,Swimming,1972,0,1,2,3
3169,HUN,Fencing,1972,6,8,6,20
3170,HUN,Football,1972,0,17,0,17
3171,HUN,Shooting,1972,0,0,1,1
3172,HUN,Canoeing,1972,0,3,2,5
3173,HUN,Water Polo,1972,0,11,0,11
3174,HUN,Modern Pentathlon,1972,1,3,0,4
3175,HUN,Gymnastics,1972,0,0,6,6
3176,HUN,Weightlifting,1976,0,1,1,2
3177,HUN,Wrestling,1976,0,1,1,2
3178,HUN,Athletics,1976,1,0,0,1
3179,HUN,Judo,1976,0,0,1,1
3180,HUN,Fencing,1976,1,0,6,7
3181,HUN,Canoeing,1976,0,4,8,12
3182,HUN,Water Polo,1976,11,0,0,11
3183,HUN,Modern Pentathlon,1976,0,0,3,3
3184,HUN,Gymnastics,1976,1,0,1,2
3185,HUN,Handball,1976,0,0,14,14
3186,HUN,Sailing,1980,0,0,2,2
3187,HUN,Weightlifting,1980,1,0,1,2
3188,HUN,Wrestling,1980,2,3,2,7
3189,HUN,Boxing,1980,0,0,2,2
3190,HUN,Judo,1980,0,0,2,2
3191,HUN,Swimming,1980,1,2,1,4
3192,HUN,Fencing,1980,0,2,11,13
3193,HUN,Shooting,1980,1,0,0,1
3194,HUN,Canoeing,1980,2,2,2,6
3195,HUN,Water Polo,1980,0,0,11,11
3196,HUN,Modern Pentathlon,1980,0,4,0,4
3197,HUN,Gymnastics,1980,1,0,6,7
3198,HUN,Weightlifting,1988,0,2,0,2
3199,HUN,Wrestling,1988,1,1,0,2
3200,HUN,Boxing,1988,0,0,1,1
3201,HUN,Swimming,1988,4,2,0,6
3202,HUN,Fencing,1988,5,0,10,15
3203,HUN,Shooting,1988,0,0,2,2
3204,HUN,Canoeing,1988,5,4,2,11
3205,HUN,Modern Pentathlon,1988,4,0,0,4
3206,HUN,Gymnastics,1988,1,0,0,1
3207,HUN,Wrestling,1992,2,0,0,2
3208,HUN,Boxing,1992,0,0,3,3
3209,HUN,Judo,1992,1,2,1,4
3210,HUN,Swimming,1992,5,3,1,9
3211,HUN,Fencing,1992,1,10,0,11
3212,HUN,Canoeing,1992,4,6,3,13
3213,HUN,Modern Pentathlon,1992,0,1,0,1
3214,HUN,Gymnastics,1992,1,1,0,2
3215,HUN,Weightlifting,1996,0,0,1,1
3216,HUN,Boxing,1996,1,0,0,1
3217,HUN,Athletics,1996,1,0,0,1
3218,HUN,Swimming,1996,3,1,2,6
3219,HUN,Fencing,1996,0,3,2,5
3220,HUN,Canoeing,1996,3,4,4,11
3221,HUN,Modern Pentathlon,1996,0,0,1,1
3222,HUN,Gymnastics,1996,0,1,0,1
3223,HUN,Handball,1996,0,0,16,16
3224,HUN,Weightlifting,2000,0,1,0,1
3225,HUN,Wrestling,2000,0,1,0,1
3226,HUN,Boxing,2000,0,0,1,1
3227,HUN,Swimming,2000,1,0,0,1
3228,HUN,Fencing,2000,1,0,0,1
3229,HUN,Shooting,2000,0,0,1,1
3230,HUN,Canoeing,2000,9,6,2,17
3231,HUN,Water Polo,2000,13,0,0,13
3232,HUN,Modern Pentathlon,2000,0,1,0,1
3233,HUN,Gymnastics,2000,1,0,0,1
3234,HUN,Handball,2000,0,15,0,15
3235,HUN,Weightlifting,2004,0,1,0,1
3236,HUN,Wrestling,2004,1,0,0,1
3237,HUN,Athletics,2004,0,1,0,1
3238,HUN,Swimming,2004,0,1,1,2
3239,HUN,Fencing,2004,1,5,0,6
3240,HUN,Shooting,2004,1,0,0,1
3241,HUN,Canoeing,2004,7,4,3,14
3242,HUN,Water Polo,2004,13,0,0,13
3243,HUN,Modern Pentathlon,2004,1,0,0,1
3244,HUN,Wrestling,2008,0,1,0,1
3245,HUN,Swimming,2008,0,3,0,3
3246,HUN,Fencing,2008,0,0,1,1
3247,HUN,Canoeing,2008,3,4,2,9
3248,HUN,Water Polo,2008,13,0,0,13
3249,HUN,Wrestling,2012,0,1,2,3
3250,HUN,Athletics,2012,1,0,0,1
3251,HUN,Judo,2012,0,1,1,2
3252,HUN,Swimming,2012,2,0,1,3
3253,HUN,Fencing,2012,1,0,0,1
3254,HUN,Canoeing,2012,7,6,1,14
3255,HUN,Modern Pentathlon,2012,0,0,1,1
3256,HUN,Gymnastics,2012,1,0,0,1
3257,HUN,Athletics,2016,0,0,1,1
3258,HUN,Swimming,2016,3,2,2,7
3259,HUN,Fencing,2016,2,1,4,7
3260,HUN,Canoeing,2016,7,0,0,7
3261,HUN,Sailing,2020,0,1,0,1
3262,HUN,Wrestling,2020,1,1,0,2
3263,HUN,Judo,2020,0,0,1,1
3264,HUN,Swimming,2020,1,1,0,2
3265,HUN,Fencing,2020,1,1,4,6
3266,HUN,Water Polo,2020,0,0,26,26
3267,HUN,Modern Pentathlon,2020,0,0,1,1
3268,HUN,Canoe Sprint,2020,6,2,2,10
3269,HUN,Marathon Swimming,2020,0,1,0,1
3270,HUN,Karate,2020,0,0,1,1
3271,HUN,Taekwondo,2024,1,0,0,1
3272,HUN,Athletics,2024,0,1,0,1
3273,HUN,Swimming,2024,2,1,0,3
3274,HUN,Fencing,2024,4,4,1,9
3275,HUN,Shooting,2024,0,0,1,1
3276,HUN,Modern Pentathlon,2024,1,0,0,1
3277,HUN,Canoe Sprint,2024,0,6,7,13
3278,HUN,Marathon Swimming,2024,1,0,0,1
3279,INA,Archery,1988,0,3,0,3
3280,INA,Badminton,1992,2,3,1,6
3281,INA,Badminton,1996,2,1,3,6
3282,INA,Weightlifting,2000,0,1,2,3
3283,INA,Badminton,2000,2,3,0,5
3284,INA,Weightlifting,2004,0,1,0,1
3285,INA,Badminton,2004,1,0,3,4
3286,INA,Weightlifting,2008,0,0,2,2
3287,INA,Badminton,2008,2,2,1,5
3288,INA,Weightlifting,2012,0,1,1,2
3289,INA,Weightlifting,2016,0,2,0,2
3290,INA,Badminton,2016,2,0,0,2
3291,INA,Weightlifting,2020,0,1,2,3
3292,INA,Badminton,2020,2,0,1,3
3293,INA,Weightlifting,2024,1,0,0,1
3294,INA,Sport Climbing,2024,1,0,0,1
3295,INA,Badminton,2024,0,0,1,1
3296,IND,Athletics,1900,0,2,0,2
3297,IND,Hockey,1928,14,0,0,14
3298,IND,Hockey,1932,15,0,0,15
3299,IND,Hockey,1936,19,0,0,19
3300,IND,Hockey,1948,20,0,0,20
3301,IND,Wrestling,1952,0,0,1,1
3302,IND,Hockey,1952,14,0,0,14
3303,IND,Hockey,1956,17,0,0,17
3304,IND,Hockey,1960,0,13,0,13
3305,IND,Hockey,1964,15,0,0,15
3306,IND,Hockey,1968,0,0,16,16
3307,IND,Hockey,1972,0,0,14,14
3308,IND,Hockey,1980,16,0,0,16
3309,IND,Tennis,1996,0,0,1,1
3310,IND,Weightlifting,2000,0,0,1,1
3311,IND,Shooting,2004,0,1,0,1
3312,IND,Wrestling,2008,0,0,1,1
3313,IND,Boxing,2008,0,0,1,1
3314,IND,Shooting,2008,1,0,0,1
3315,IND,Wrestling,2012,0,1,1,2
3316,IND,Boxing,2012,0,0,1,1
3317,IND,Shooting,2012,0,1,1,2
3318,IND,Badminton,2012,0,0,1,1
3319,IND,Wrestling,2016,0,0,1,1
3320,IND,Badminton,2016,0,1,0,1
3321,IND,Weightlifting,2020,0,1,0,1
3322,IND,Wrestling,2020,0,1,1,2
3323,IND,Boxing,2020,0,0,1,1
3324,IND,Athletics,2020,1,0,0,1
3325,IND,Hockey,2020,0,0,18,18
3326,IND,Badminton,2020,0,0,1,1
3327,IND,Wrestling,2024,0,0,1,1
3328,IND,Athletics,2024,0,1,0,1
3329,IND,Shooting,2024,0,0,4,4
3330,IND,Hockey,2024,0,0,16,16
3331,IOA,Shooting,1992,0,1,2,3
3332,IOA,Shooting,2016,1,0,1,2
3333,IRI,Weightlifting,1948,0,0,1,1
3334,IRI,Weightlifting,1952,0,1,1,2
3335,IRI,Wrestling,1952,0,2,3,5
3336,IRI,Weightlifting,1956,0,0,1,1
3337,IRI,Wrestling,1956,2,2,0,4
3338,IRI,Weightlifting,1960,0,0,1,1
3339,IRI,Wrestling,1960,0,1,2,3
3340,IRI,Wrestling,1964,0,0,2,2
3341,IRI,Weightlifting,1968,1,1,0,2
3342,IRI,Wrestling,1968,1,0,2,3
3343,IRI,Weightlifting,1972,0,1,0,1
3344,IRI,Wrestling,1972,0,1,1,2
3345,IRI,Weightlifting,1976,0,0,1,1
3346,IRI,Wrestling,1976,0,1,0,1
3347,IRI,Wrestling,1988,0,1,0,1
3348,IRI,Wrestling,1992,0,1,2,3
3349,IRI,Wrestling,1996,1,1,1,3
3350,IRI,Taekwondo,2000,0,0,1,1
3351,IRI,Weightlifting,2000,2,0,0,2
3352,IRI,Wrestling,2000,1,0,0,1
3353,IRI,Taekwondo,2004,1,0,1,2
3354,IRI,Weightlifting,2004,1,0,0,1
3355,IRI,Wrestling,2004,0,2,1,3
3356,IRI,Taekwondo,2008,1,0,0,1
3357,IRI,Wrestling,2008,0,0,1,1
3358,IRI,Taekwondo,2012,0,1,0,1
3359,IRI,Weightlifting,2012,1,2,1,4
3360,IRI,Wrestling,2012,3,1,2,6
3361,IRI,Athletics,2012,0,1,0,1
3362,IRI,Taekwondo,2016,0,0,1,1
3363,IRI,Weightlifting,2016,2,0,0,2
3364,IRI,Wrestling,2016,1,1,3,5
3365,IRI,Weightlifting,2020,0,1,0,1
3366,IRI,Wrestling,2020,1,1,2,4
3367,IRI,Shooting,2020,1,0,0,1
3368,IRI,Karate,2020,1,0,0,1
3369,IRI,Taekwondo,2024,1,2,1,4
3370,IRI,Wrestling,2024,2,4,2,8
3371,IRL,Art Competitions,1924,0,1,1,2
3372,IRL,Athletics,1928,1,0,0,1
3373,IRL,Athletics,1932,2,0,0,2
3374,IRL,Art Competitions,1948,0,0,1,1
3375,IRL,Boxing,1952,0,1,0,1
3376,IRL,Boxing,1956,0,1,3,4
3377,IRL,Athletics,1956,1,0,0,1
3378,IRL,Boxing,1964,0,0,1,1
3379,IRL,Sailing,1980,0,2,0,2
3380,IRL,Boxing,1980,0,0,1,1
3381,IRL,Athletics,1984,0,1,0,1
3382,IRL,Boxing,1992,1,1,0,2
3383,IRL,Swimming,1996,3,0,1,4
3384,IRL,Athletics,2000,0,1,0,1
3385,IRL,Boxing,2008,0,1,2,3
3386,IRL,Boxing,2012,1,1,2,4
3387,IRL,Equestrianism,2012,0,0,1,1
3388,IRL,Sailing,2016,0,1,0,1
3389,IRL,Rowing,2016,0,2,0,2
3390,IRL,Rowing,2020,2,0,4,6
3391,IRL,Boxing,2020,1,0,1,2
3392,IRL,Rowing,2024,2,0,2,4
3393,IRL,Boxing,2024,1,0,0,1
3394,IRL,Artistic Gymnastics,2024,1,0,0,1
3395,IRL,Swimming,2024,0,0,1,1
3396,IRQ,Weightlifting,1960,0,0,1,1
3397,ISL,Athletics,1956,0,1,0,1
3398,ISL,Judo,1984,0,0,1,1
3399,ISL,Athletics,2000,0,0,1,1
3400,ISL,Handball,2008,0,14,0,14
3401,ISR,Judo,1992,0,1,1,2
3402,ISR,Sailing,1996,0,0,1,1
3403,ISR,Canoeing,2000,0,0,1,1
3404,ISR,Sailing,2004,1,0,0,1
3405,ISR,Judo,2004,0,0,1,1
3406,ISR,Sailing,2008,0,0,1,1
3407,ISR,Judo,2016,0,0,2,2
3408,ISR,Taekwondo,2020,0,0,1,1
3409,ISR,Judo,2020,0,0,11,11
3410,ISR,Artistic Gymnastics,2020,1,0,0,1
3411,ISR,Rhythmic Gymnastics,2020,1,0,0,1
3412,ISR,Sailing,2024,1,1,0,2
3413,ISR,Judo,2024,0,2,1,3
3414,ISR,Artistic Gymnastics,2024,0,1,0,1
3415,ISR,Rhythmic Gymnastics,2024,0,5,0,5
3416,ISV,Sailing,1988,0,1,0,1
3417,ITA,Fencing,1900,1,1,0,2
3418,ITA,Equestrianism,1900,1,1,0,2
3419,ITA,Cycling,1900,1,0,0,1
3420,ITA,Rowing,1906,18,3,17,38
3421,ITA,Weightlifting,1906,0,1,0,1
3422,ITA,Fencing,1906,0,1,1,2
3423,ITA,Shooting,1906,0,1,0,1
3424,ITA,Cycling,1906,3,0,0,3
3425,ITA,Gymnastics,1906,0,2,9,11
3426,ITA,Wrestling,1908,1,0,0,1
3427,ITA,Athletics,1908,0,1,0,1
3428,ITA,Fencing,1908,0,5,0,5
3429,ITA,Gymnastics,1908,1,0,0,1
3430,ITA,Athletics,1912,0,0,1,1
3431,ITA,Fencing,1912,1,1,0,2
3432,ITA,Gymnastics,1912,19,0,1,20
3433,ITA,Art Competitions,1912,2,0,0,2
3434,ITA,Rowing,1920,3,2,0,5
3435,ITA,Weightlifting,1920,1,1,0,2
3436,ITA,Boxing,1920,0,0,1,1
3437,ITA,Athletics,1920,2,0,2,4
3438,ITA,Fencing,1920,27,1,0,28
3439,ITA,Equestrianism,1920,1,4,5,10
3440,ITA,Cycling,1920,4,0,0,4
3441,ITA,Gymnastics,1920,28,0,0,28
3442,ITA,Art Competitions,1920,1,1,0,2
3443,ITA,Rowing,1924,0,3,9,12
3444,ITA,Tennis,1924,0,0,1,1
3445,ITA,Weightlifting,1924,3,0,0,3
3446,ITA,Athletics,1924,1,1,0,2
3447,ITA,Fencing,1924,8,0,6,14
3448,ITA,Equestrianism,1924,0,1,4,5
3449,ITA,Cycling,1924,4,0,0,4
3450,ITA,Gymnastics,1924,9,0,1,10
3451,ITA,Rowing,1928,5,0,4,9
3452,ITA,Weightlifting,1928,0,2,0,2
3453,ITA,Wrestling,1928,0,0,2,2
3454,ITA,Boxing,1928,3,0,1,4
3455,ITA,Fencing,1928,12,6,2,20
3456,ITA,Football,1928,0,0,17,17
3457,ITA,Cycling,1928,4,0,0,4
3458,ITA,Gymnastics,1928,0,13,0,13
3459,ITA,Art Competitions,1928,0,1,0,1
3460,ITA,Rowing,1932,0,14,4,18
3461,ITA,Weightlifting,1932,0,1,1,2
3462,ITA,Wrestling,1932,1,1,2,4
3463,ITA,Boxing,1932,0,2,0,2
3464,ITA,Athletics,1932,1,0,5,6
3465,ITA,Fencing,1932,2,18,2,22
3466,ITA,Shooting,1932,1,0,1,2
3467,ITA,Cycling,1932,8,1,1,10
3468,ITA,Gymnastics,1932,8,1,2,11
3469,ITA,Sailing,1936,6,0,0,6
3470,ITA,Rowing,1936,0,12,0,12
3471,ITA,Boxing,1936,1,1,0,2
3472,ITA,Athletics,1936,1,5,2,8
3473,ITA,Fencing,1936,14,8,2,24
3474,ITA,Football,1936,14,0,0,14
3475,ITA,Cycling,1936,0,4,0,4
3476,ITA,Modern Pentathlon,1936,0,0,1,1
3477,ITA,Art Competitions,1936,1,4,0,5
3478,ITA,Rowing,1948,4,3,3,10
3479,ITA,Wrestling,1948,1,0,2,3
3480,ITA,Boxing,1948,1,2,2,5
3481,ITA,Athletics,1948,1,3,4,8
3482,ITA,Fencing,1948,1,19,1,21
3483,ITA,Cycling,1948,3,4,0,7
3484,ITA,Water Polo,1948,9,0,0,9
3485,ITA,Art Competitions,1948,1,1,2,4
3486,ITA,Sailing,1952,2,0,0,2
3487,ITA,Wrestling,1952,0,1,0,1
3488,ITA,Boxing,1952,1,1,1,3
3489,ITA,Athletics,1952,1,1,0,2
3490,ITA,Fencing,1952,8,14,1,23
3491,ITA,Cycling,1952,5,5,2,12
3492,ITA,Water Polo,1952,0,0,11,11
3493,ITA,Sailing,1956,0,2,0,2
3494,ITA,Rowing,1956,5,0,0,5
3495,ITA,Weightlifting,1956,0,0,2,2
3496,ITA,Wrestling,1956,0,1,1,2
3497,ITA,Boxing,1956,0,1,1,2
3498,ITA,Fencing,1956,13,2,2,17
3499,ITA,Shooting,1956,1,0,1,2
3500,ITA,Equestrianism,1956,0,4,1,5
3501,ITA,Cycling,1956,7,1,2,10
3502,ITA,Sailing,1960,0,0,3,3
3503,ITA,Rowing,1960,0,4,5,9
3504,ITA,Weightlifting,1960,0,0,1,1
3505,ITA,Boxing,1960,3,3,1,7
3506,ITA,Athletics,1960,1,0,2,3
3507,ITA,Fencing,1960,7,5,11,23
3508,ITA,Shooting,1960,0,1,0,1
3509,ITA,Equestrianism,1960,1,1,3,5
3510,ITA,Cycling,1960,12,1,1,14
3511,ITA,Canoeing,1960,0,2,0,2
3512,ITA,Water Polo,1960,12,0,0,12
3513,ITA,Gymnastics,1960,0,1,7,8
3514,ITA,Rowing,1964,0,5,0,5
3515,ITA,Boxing,1964,2,0,3,5
3516,ITA,Athletics,1964,1,0,1,2
3517,ITA,Fencing,1964,0,10,1,11
3518,ITA,Shooting,1964,1,0,0,1
3519,ITA,Equestrianism,1964,5,0,3,8
3520,ITA,Cycling,1964,4,11,0,15
3521,ITA,Diving,1964,0,1,0,1
3522,ITA,Gymnastics,1964,1,1,1,3
3523,ITA,Sailing,1968,0,0,3,3
3524,ITA,Rowing,1968,3,0,4,7
3525,ITA,Boxing,1968,0,0,1,1
3526,ITA,Athletics,1968,0,0,2,2
3527,ITA,Fencing,1968,0,5,1,6
3528,ITA,Shooting,1968,0,1,0,1
3529,ITA,Cycling,1968,1,1,9,11
3530,ITA,Diving,1968,1,1,0,2
3531,ITA,Weightlifting,1972,0,0,1,1
3532,ITA,Wrestling,1972,0,0,2,2
3533,ITA,Athletics,1972,0,0,2,2
3534,ITA,Swimming,1972,0,1,2,3
3535,ITA,Fencing,1972,6,0,0,6
3536,ITA,Shooting,1972,1,0,1,2
3537,ITA,Equestrianism,1972,1,1,4,6
3538,ITA,Diving,1972,1,1,1,3
3539,ITA,Athletics,1976,0,1,0,1
3540,ITA,Judo,1976,0,0,1,1
3541,ITA,Fencing,1976,1,11,0,12
3542,ITA,Shooting,1976,0,0,2,2
3543,ITA,Cycling,1976,0,1,0,1
3544,ITA,Diving,1976,1,1,0,2
3545,ITA,Archery,1976,0,0,1,1
3546,ITA,Water Polo,1976,0,11,0,11
3547,ITA,Sailing,1980,0,0,2,2
3548,ITA,Wrestling,1980,1,0,0,1
3549,ITA,Boxing,1980,1,0,0,1
3550,ITA,Athletics,1980,3,0,4,7
3551,ITA,Judo,1980,1,0,0,1
3552,ITA,Fencing,1980,0,5,0,5
3553,ITA,Shooting,1980,1,0,0,1
3554,ITA,Equestrianism,1980,1,4,0,5
3555,ITA,Basketball,1980,0,12,0,12
3556,ITA,Diving,1980,0,0,1,1
3557,ITA,Archery,1980,0,0,1,1
3558,ITA,Sailing,1984,0,0,2,2
3559,ITA,Rowing,1984,3,0,0,3
3560,ITA,Weightlifting,1984,1,0,0,1
3561,ITA,Wrestling,1984,1,0,0,1
3562,ITA,Boxing,1984,1,2,2,5
3563,ITA,Athletics,1984,3,1,3,7
3564,ITA,Judo,1984,0,1,0,1
3565,ITA,Fencing,1984,11,1,7,19
3566,ITA,Shooting,1984,1,1,1,3
3567,ITA,Volleyball,1984,0,0,12,12
3568,ITA,Cycling,1984,4,0,0,4
3569,ITA,Modern Pentathlon,1984,4,0,1,5
3570,ITA,Rowing,1988,7,0,0,7
3571,ITA,Wrestling,1988,1,0,0,1
3572,ITA,Boxing,1988,1,0,0,1
3573,ITA,Athletics,1988,1,1,1,3
3574,ITA,Swimming,1988,0,0,1,1
3575,ITA,Fencing,1988,1,5,6,12
3576,ITA,Modern Pentathlon,1988,0,4,0,4
3577,ITA,Rowing,1992,0,3,4,7
3578,ITA,Wrestling,1992,0,1,0,1
3579,ITA,Athletics,1992,0,0,1,1
3580,ITA,Judo,1992,0,1,0,1
3581,ITA,Swimming,1992,0,0,2,2
3582,ITA,Fencing,1992,6,1,0,7
3583,ITA,Shooting,1992,0,0,2,2
3584,ITA,Cycling,1992,2,4,0,6
3585,ITA,Canoeing,1992,1,0,2,3
3586,ITA,Water Polo,1992,12,0,0,12
3587,ITA,Modern Pentathlon,1992,0,0,3,3
3588,ITA,Sailing,1996,0,0,1,1
3589,ITA,Rowing,1996,2,0,0,2
3590,ITA,Athletics,1996,0,2,2,4
3591,ITA,Judo,1996,0,1,1,2
3592,ITA,Swimming,1996,0,0,1,1
3593,ITA,Fencing,1996,7,4,4,15
3594,ITA,Shooting,1996,2,1,2,5
3595,ITA,Volleyball,1996,0,12,0,12
3596,ITA,Cycling,1996,4,1,0,5
3597,ITA,Canoeing,1996,3,3,1,7
3598,ITA,Archery,1996,0,0,3,3
3599,ITA,Water Polo,1996,0,0,13,13
3600,ITA,Gymnastics,1996,1,0,0,1
3601,ITA,Sailing,2000,1,1,0,2
3602,ITA,Rowing,2000,4,6,2,12
3603,ITA,Boxing,2000,0,0,1,1
3604,ITA,Athletics,2000,0,2,0,2
3605,ITA,Judo,2000,1,0,3,4
3606,ITA,Swimming,2000,3,1,2,6
3607,ITA,Fencing,2000,8,0,5,13
3608,ITA,Shooting,2000,0,1,1,2
3609,ITA,Volleyball,2000,0,0,12,12
3610,ITA,Cycling,2000,2,0,2,4
3611,ITA,Canoeing,2000,3,0,1,4
3612,ITA,Archery,2000,0,3,0,3
3613,ITA,Sailing,2004,0,0,1,1
3614,ITA,Rowing,2004,0,0,10,10
3615,ITA,Boxing,2004,0,0,1,1
3616,ITA,Athletics,2004,2,0,1,3
3617,ITA,Judo,2004,0,0,1,1
3618,ITA,Swimming,2004,0,1,6,7
3619,ITA,Fencing,2004,5,5,1,11
3620,ITA,Football,2004,0,0,17,17
3621,ITA,Shooting,2004,1,2,0,3
3622,ITA,Volleyball,2004,0,12,0,12
3623,ITA,Basketball,2004,0,12,0,12
3624,ITA,Cycling,2004,1,0,0,1
3625,ITA,Canoeing,2004,0,3,0,3
3626,ITA,Archery,2004,1,0,0,1
3627,ITA,Water Polo,2004,13,0,0,13
3628,ITA,Gymnastics,2004,1,0,1,2
3629,ITA,Rhythmic Gymnastics,2004,0,6,0,6
3630,ITA,Taekwondo,2008,0,1,0,1
3631,ITA,Sailing,2008,0,1,1,2
3632,ITA,Rowing,2008,0,4,0,4
3633,ITA,Wrestling,2008,1,0,0,1
3634,ITA,Boxing,2008,1,1,1,3
3635,ITA,Athletics,2008,1,0,1,2
3636,ITA,Judo,2008,1,0,0,1
3637,ITA,Swimming,2008,1,1,0,2
3638,ITA,Fencing,2008,2,0,14,16
3639,ITA,Shooting,2008,1,2,0,3
3640,ITA,Cycling,2008,0,0,1,1
3641,ITA,Canoeing,2008,0,1,2,3
3642,ITA,Archery,2008,0,3,0,3
3643,ITA,Taekwondo,2012,1,0,1,2
3644,ITA,Rowing,2012,0,2,0,2
3645,ITA,Boxing,2012,0,2,1,3
3646,ITA,Athletics,2012,0,0,1,1
3647,ITA,Judo,2012,0,0,1,1
3648,ITA,Swimming,2012,0,0,1,1
3649,ITA,Fencing,2012,9,2,5,16
3650,ITA,Shooting,2012,2,3,0,5
3651,ITA,Volleyball,2012,0,0,12,12
3652,ITA,Cycling,2012,0,0,1,1
3653,ITA,Canoeing,2012,1,0,0,1
3654,ITA,Archery,2012,3,0,0,3
3655,ITA,Water Polo,2012,0,13,0,13
3656,ITA,Gymnastics,2012,0,0,1,1
3657,ITA,Rhythmic Gymnastics,2012,0,0,6,6
3658,ITA,Rowing,2016,0,0,6,6
3659,ITA,Wrestling,2016,0,0,1,1
3660,ITA,Judo,2016,1,1,0,2
3661,ITA,Swimming,2016,1,1,2,4
3662,ITA,Fencing,2016,1,6,0,7
3663,ITA,Shooting,2016,4,3,0,7
3664,ITA,Volleyball,2016,0,12,0,12
3665,ITA,Cycling,2016,1,0,1,2
3666,ITA,Diving,2016,0,2,1,3
3667,ITA,Beach Volleyball,2016,0,2,0,2
3668,ITA,Water Polo,2016,0,13,13,26
3669,ITA,Taekwondo,2020,1,0,0,1
3670,ITA,Sailing,2020,2,0,0,2
3671,ITA,Rowing,2020,2,0,6,8
3672,ITA,Weightlifting,2020,0,1,2,3
3673,ITA,Wrestling,2020,0,0,1,1
3674,ITA,Boxing,2020,0,0,1,1
3675,ITA,Athletics,2020,10,0,0,10
3676,ITA,Judo,2020,0,0,2,2
3677,ITA,Artistic Gymnastics,2020,0,1,0,1
3678,ITA,Swimming,2020,0,6,7,13
3679,ITA,Fencing,2020,0,6,8,14
3680,ITA,Shooting,2020,0,1,0,1
3681,ITA,Archery,2020,0,1,1,2
3682,ITA,Canoe Sprint,2020,0,1,0,1
3683,ITA,Cycling Road,2020,0,0,1,1
3684,ITA,Cycling Track,2020,6,0,1,7
3685,ITA,Marathon Swimming,2020,0,0,1,1
3686,ITA,Karate,2020,1,0,1,2
3687,ITA,Rhythmic Gymnastics,2020,0,0,5,5
3688,ITA,Taekwondo,2024,0,0,1,1
3689,ITA,Sailing,2024,3,0,0,3
3690,ITA,Rowing,2024,0,6,0,6
3691,ITA,Tennis,2024,2,0,1,3
3692,ITA,Weightlifting,2024,0,0,1,1
3693,ITA,Athletics,2024,0,1,2,3
3694,ITA,Judo,2024,1,0,0,1
3695,ITA,Artistic Gymnastics,2024,1,5,1,7
3696,ITA,Swimming,2024,2,0,6,8
3697,ITA,Fencing,2024,4,9,1,14
3698,ITA,Shooting,2024,2,2,1,5
3699,ITA,Volleyball,2024,13,0,0,13
3700,ITA,Modern Pentathlon,2024,0,0,1,1
3701,ITA,Canoe Slalom,2024,1,0,0,1
3702,ITA,Canoe Sprint,2024,0,2,0,2
3703,ITA,Cycling Track,2024,2,1,4,7
3704,ITA,Rhythmic Gymnastics,2024,0,0,6,6
3705,JAM,Athletics,1948,1,2,0,3
3706,JAM,Athletics,1952,5,3,0,8
3707,JAM,Athletics,1968,0,1,0,1
3708,JAM,Athletics,1972,0,0,1,1
3709,JAM,Athletics,1976,1,1,0,2
3710,JAM,Athletics,1980,0,0,2,2
3711,JAM,Cycling,1980,0,0,1,1
3712,JAM,Athletics,1984,0,5,2,7
3713,JAM,Athletics,1988,0,7,0,7
3714,JAM,Athletics,1992,0,3,1,4
3715,JAM,Athletics,1996,1,3,12,16
3716,JAM,Athletics,2000,0,20,3,23
3717,JAM,Athletics,2004,6,1,6,13
3718,JAM,Athletics,2008,5,3,6,14
3719,JAM,Athletics,2012,8,9,8,25
3720,JAM,Athletics,2016,11,17,2,30
3721,JAM,Athletics,2020,9,1,11,21
3722,JAM,Athletics,2024,1,3,2,6
3723,JOR,Taekwondo,2016,1,0,0,1
3724,JOR,Taekwondo,2020,0,1,0,1
3725,JOR,Karate,2020,0,0,1,1
3726,JOR,Taekwondo,2024,0,1,0,1
3727,JPN,Tennis,1920,0,3,0,3
3728,JPN,Wrestling,1924,0,0,1,1
3729,JPN,Athletics,1928,1,1,0,2
3730,JPN,Swimming,1928,1,5,1,7
3731,JPN,Athletics,1932,1,1,2,4
3732,JPN,Swimming,1932,8,5,2,15
3733,JPN,Equestrianism,1932,1,0,0,1
3734,JPN,Hockey,1932,0,11,0,11
3735,JPN,Athletics,1936,2,2,3,7
3736,JPN,Swimming,1936,7,2,5,14
3737,JPN,Art Competitions,1936,0,0,2,2
3738,JPN,Wrestling,1952,1,1,0,2
3739,JPN,Swimming,1952,0,6,0,6
3740,JPN,Gymnastics,1952,0,2,2,4
3741,JPN,Wrestling,1956,2,1,0,3
3742,JPN,Swimming,1956,1,4,0,5
3743,JPN,Gymnastics,1956,1,10,5,16
3744,JPN,Weightlifting,1960,0,1,0,1
3745,JPN,Wrestling,1960,0,1,0,1
3746,JPN,Boxing,1960,0,0,1,1
3747,JPN,Swimming,1960,0,6,7,13
3748,JPN,Shooting,1960,0,0,1,1
3749,JPN,Gymnastics,1960,9,2,3,14
3750,JPN,Weightlifting,1964,1,0,2,3
3751,JPN,Wrestling,1964,5,0,1,6
3752,JPN,Boxing,1964,1,0,0,1
3753,JPN,Athletics,1964,0,0,1,1
3754,JPN,Judo,1964,3,1,0,4
3755,JPN,Swimming,1964,0,0,5,5
3756,JPN,Shooting,1964,0,0,1,1
3757,JPN,Volleyball,1964,12,0,9,21
3758,JPN,Gymnastics,1964,10,4,6,20
3759,JPN,Weightlifting,1968,1,1,1,3
3760,JPN,Wrestling,1968,4,1,0,5
3761,JPN,Boxing,1968,0,0,1,1
3762,JPN,Athletics,1968,0,1,0,1
3763,JPN,Football,1968,0,0,16,16
3764,JPN,Volleyball,1968,0,20,0,20
3765,JPN,Gymnastics,1968,11,2,4,17
3766,JPN,Wrestling,1972,2,2,0,4
3767,JPN,Judo,1972,3,0,1,4
3768,JPN,Swimming,1972,2,0,1,3
3769,JPN,Volleyball,1972,12,12,0,24
3770,JPN,Gymnastics,1972,10,5,6,21
3771,JPN,Weightlifting,1976,0,0,2,2
3772,JPN,Wrestling,1976,2,0,4,6
3773,JPN,Judo,1976,3,1,1,5
3774,JPN,Volleyball,1976,12,0,0,12
3775,JPN,Archery,1976,0,1,0,1
3776,JPN,Gymnastics,1976,8,4,3,15
3777,JPN,Weightlifting,1984,0,0,3,3
3778,JPN,Wrestling,1984,2,5,2,9
3779,JPN,Judo,1984,4,0,1,5
3780,JPN,Shooting,1984,1,0,0,1
3781,JPN,Volleyball,1984,0,0,12,12
3782,JPN,Cycling,1984,0,0,1,1
3783,JPN,Archery,1984,0,0,1,1
3784,JPN,Gymnastics,1984,3,3,8,14
3785,JPN,Synchronized Swimming,1984,0,0,3,3
3786,JPN,Wrestling,1988,2,2,0,4
3787,JPN,Judo,1988,1,0,3,4
3788,JPN,Swimming,1988,1,0,0,1
3789,JPN,Shooting,1988,0,1,0,1
3790,JPN,Gymnastics,1988,0,0,7,7
3791,JPN,Synchronized Swimming,1988,0,0,3,3
3792,JPN,Wrestling,1992,0,0,1,1
3793,JPN,Athletics,1992,0,2,0,2
3794,JPN,Judo,1992,2,4,4,10
3795,JPN,Swimming,1992,1,0,0,1
3796,JPN,Shooting,1992,0,1,1,2
3797,JPN,Baseball,1992,0,0,20,20
3798,JPN,Gymnastics,1992,0,1,7,8
3799,JPN,Synchronized Swimming,1992,0,0,3,3
3800,JPN,Sailing,1996,0,2,0,2
3801,JPN,Wrestling,1996,0,0,1,1
3802,JPN,Athletics,1996,0,0,1,1
3803,JPN,Judo,1996,3,4,1,8
3804,JPN,Cycling,1996,0,0,1,1
3805,JPN,Baseball,1996,0,20,0,20
3806,JPN,Synchronized Swimming,1996,0,0,9,9
3807,JPN,Taekwondo,2000,0,0,1,1
3808,JPN,Wrestling,2000,0,1,0,1
3809,JPN,Athletics,2000,1,0,0,1
3810,JPN,Judo,2000,4,2,2,8
3811,JPN,Swimming,2000,0,2,5,7
3812,JPN,Softball,2000,0,15,0,15
3813,JPN,Synchronized Swimming,2000,0,11,0,11
3814,JPN,Sailing,2004,0,0,2,2
3815,JPN,Wrestling,2004,2,1,3,6
3816,JPN,Athletics,2004,2,0,0,2
3817,JPN,Judo,2004,8,2,0,10
3818,JPN,Swimming,2004,3,1,7,11
3819,JPN,Cycling,2004,0,3,0,3
3820,JPN,Softball,2004,0,0,14,14
3821,JPN,Archery,2004,0,1,0,1
3822,JPN,Baseball,2004,0,0,24,24
3823,JPN,Gymnastics,2004,6,1,2,9
3824,JPN,Synchronized Swimming,2004,0,11,0,11
3825,JPN,Wrestling,2008,2,2,2,6
3826,JPN,Athletics,2008,0,4,0,4
3827,JPN,Judo,2008,4,1,2,7
3828,JPN,Swimming,2008,2,0,6,8
3829,JPN,Fencing,2008,0,1,0,1
3830,JPN,Cycling,2008,0,0,1,1
3831,JPN,Softball,2008,15,0,0,15
3832,JPN,Gymnastics,2008,0,7,0,7
3833,JPN,Synchronized Swimming,2008,0,0,2,2
3834,JPN,Weightlifting,2012,0,1,0,1
3835,JPN,Wrestling,2012,4,0,2,6
3836,JPN,Boxing,2012,1,0,1,2
3837,JPN,Athletics,2012,0,0,1,1
3838,JPN,Judo,2012,1,3,3,7
3839,JPN,Swimming,2012,0,6,11,17
3840,JPN,Fencing,2012,0,4,0,4
3841,JPN,Football,2012,0,18,0,18
3842,JPN,Volleyball,2012,0,0,12,12
3843,JPN,Archery,2012,0,1,3,4
3844,JPN,Gymnastics,2012,1,6,0,7
3845,JPN,Table Tennis,2012,0,3,0,3
3846,JPN,Badminton,2012,0,2,0,2
3847,JPN,Tennis,2016,0,0,1,1
3848,JPN,Weightlifting,2016,0,0,1,1
3849,JPN,Wrestling,2016,4,3,0,7
3850,JPN,Athletics,2016,0,4,1,5
3851,JPN,Judo,2016,3,1,8,12
3852,JPN,Swimming,2016,2,2,6,10
3853,JPN,Canoeing,2016,0,0,1,1
3854,JPN,Gymnastics,2016,6,0,1,7
3855,JPN,Synchronized Swimming,2016,0,0,10,10
3856,JPN,Table Tennis,2016,0,3,4,7
3857,JPN,Badminton,2016,2,0,1,3
3858,JPN,Weightlifting,2020,0,0,1,1
3859,JPN,Wrestling,2020,5,1,1,7
3860,JPN,Boxing,2020,1,0,2,3
3861,JPN,Athletics,2020,0,1,1,2
3862,JPN,Judo,2020,9,13,1,23
3863,JPN,Artistic Gymnastics,2020,2,4,2,8
3864,JPN,Swimming,2020,2,1,0,3
3865,JPN,Fencing,2020,4,0,0,4
3866,JPN,Basketball,2020,0,12,0,12
3867,JPN,Archery,2020,0,0,4,4
3868,JPN,Cycling Track,2020,0,1,0,1
3869,JPN,Skateboarding,2020,3,1,1,5
3870,JPN,Surfing,2020,0,1,1,2
3871,JPN,Karate,2020,1,1,1,3
3872,JPN,Sport Climbing,2020,0,1,1,2
3873,JPN,Golf,2020,0,1,0,1
3874,JPN,Baseball/Softball,2020,39,0,0,39
3875,JPN,Table Tennis,2020,2,3,4,9
3876,JPN,Badminton,2020,0,0,2,2
3877,JPN,Sailing,2024,0,2,0,2
3878,JPN,Wrestling,2024,8,1,2,11
3879,JPN,Athletics,2024,1,0,0,1
3880,JPN,Judo,2024,3,15,3,21
3881,JPN,Artistic Gymnastics,2024,7,0,1,8
3882,JPN,Swimming,2024,0,1,0,1
3883,JPN,Fencing,2024,5,4,8,17
3884,JPN,Diving,2024,0,1,0,1
3885,JPN,Modern Pentathlon,2024,0,1,0,1
3886,JPN,Equestrian,2024,0,0,4,4
3887,JPN,Skateboarding,2024,2,2,0,4
3888,JPN,Sport Climbing,2024,0,1,0,1
3889,JPN,Golf,2024,0,0,1,1
3890,JPN,Breaking,2024,1,0,0,1
3891,JPN,Table Tennis,2024,0,3,1,4
3892,JPN,Badminton,2024,0,0,4,4
3893,KAZ,Weightlifting,1996,0,1,0,1
3894,KAZ,Wrestling,1996,1,0,1,2
3895,KAZ,Boxing,1996,1,1,2,4
3896,KAZ,Shooting,1996,0,2,1,3
3897,KAZ,Modern Pentathlon,1996,1,0,0,1
3898,KAZ,Wrestling,2000,0,1,0,1
3899,KAZ,Boxing,2000,2,2,0,4
3900,KAZ,Athletics,2000,1,0,0,1
3901,KAZ,Cycling,2000,0,1,0,1
3902,KAZ,Weightlifting,2004,0,1,0,1
3903,KAZ,Wrestling,2004,0,2,1,3
3904,KAZ,Boxing,2004,1,1,1,3
3905,KAZ,Athletics,2004,0,0,1,1
3906,KAZ,Taekwondo,2008,0,0,1,1
3907,KAZ,Weightlifting,2008,1,2,1,4
3908,KAZ,Wrestling,2008,0,1,4,5
3909,KAZ,Boxing,2008,1,0,1,2
3910,KAZ,Judo,2008,0,1,0,1
3911,KAZ,Weightlifting,2012,4,0,0,4
3912,KAZ,Wrestling,2012,0,0,3,3
3913,KAZ,Boxing,2012,1,1,2,4
3914,KAZ,Athletics,2012,1,0,0,1
3915,KAZ,Cycling,2012,1,0,0,1
3916,KAZ,Weightlifting,2016,1,1,4,6
3917,KAZ,Wrestling,2016,0,1,2,3
3918,KAZ,Boxing,2016,1,2,2,5
3919,KAZ,Athletics,2016,0,0,1,1
3920,KAZ,Judo,2016,0,1,1,2
3921,KAZ,Swimming,2016,1,0,0,1
3922,KAZ,Weightlifting,2020,0,0,2,2
3923,KAZ,Wrestling,2020,0,0,1,1
3924,KAZ,Boxing,2020,0,0,2,2
3925,KAZ,Judo,2020,0,0,1,1
3926,KAZ,Karate,2020,0,0,2,2
3927,KAZ,Wrestling,2024,0,1,0,1
3928,KAZ,Boxing,2024,0,1,1,2
3929,KAZ,Judo,2024,1,0,1,2
3930,KAZ,Artistic Gymnastics,2024,0,1,0,1
3931,KAZ,Shooting,2024,0,0,2,2
3932,KEN,Athletics,1964,0,0,1,1
3933,KEN,Boxing,1968,0,0,1,1
3934,KEN,Athletics,1968,3,7,1,11
3935,KEN,Boxing,1972,0,1,2,3
3936,KEN,Athletics,1972,5,2,2,9
3937,KEN,Boxing,1984,0,0,1,1
3938,KEN,Athletics,1984,1,0,1,2
3939,KEN,Boxing,1988,1,0,1,2
3940,KEN,Athletics,1988,4,2,1,7
3941,KEN,Athletics,1992,2,4,2,8
3942,KEN,Athletics,1996,1,4,3,8
3943,KEN,Athletics,2000,2,3,2,7
3944,KEN,Athletics,2004,1,4,2,7
3945,KEN,Athletics,2008,6,4,5,15
3946,KEN,Athletics,2012,2,4,5,11
3947,KEN,Athletics,2016,6,6,1,13
3948,KEN,Athletics,2020,4,4,2,10
3949,KEN,Athletics,2024,4,2,5,11
3950,KGZ,Judo,2000,0,0,1,1
3951,KGZ,Wrestling,2008,0,1,1,2
3952,KGZ,Wrestling,2020,0,2,1,3
3953,KGZ,Wrestling,2024,0,1,4,5
3954,KGZ,Boxing,2024,0,1,0,1
3955,KOR,Weightlifting,1948,0,0,1,1
3956,KOR,Boxing,1948,0,0,1,1
3957,KOR,Weightlifting,1952,0,0,1,1
3958,KOR,Boxing,1952,0,0,1,1
3959,KOR,Weightlifting,1956,0,0,1,1
3960,KOR,Boxing,1956,0,1,0,1
3961,KOR,Wrestling,1964,0,1,0,1
3962,KOR,Boxing,1964,0,1,0,1
3963,KOR,Judo,1964,0,0,1,1
3964,KOR,Boxing,1968,0,1,1,2
3965,KOR,Judo,1972,0,1,0,1
3966,KOR,Wrestling,1976,1,0,1,2
3967,KOR,Judo,1976,0,1,2,3
3968,KOR,Volleyball,1976,0,0,12,12
3969,KOR,Wrestling,1984,2,1,4,7
3970,KOR,Boxing,1984,1,1,1,3
3971,KOR,Judo,1984,2,2,1,5
3972,KOR,Basketball,1984,0,11,0,11
3973,KOR,Archery,1984,1,0,1,2
3974,KOR,Handball,1984,0,13,0,13
3975,KOR,Weightlifting,1988,0,1,1,2
3976,KOR,Wrestling,1988,2,2,5,9
3977,KOR,Boxing,1988,2,1,1,4
3978,KOR,Judo,1988,2,0,1,3
3979,KOR,Shooting,1988,0,1,0,1
3980,KOR,Hockey,1988,0,16,0,16
3981,KOR,Archery,1988,7,2,1,10
3982,KOR,Gymnastics,1988,0,0,1,1
3983,KOR,Handball,1988,12,13,0,25
3984,KOR,Table Tennis,1988,3,1,2,6
3985,KOR,Weightlifting,1992,1,0,0,1
3986,KOR,Wrestling,1992,2,1,1,4
3987,KOR,Boxing,1992,0,0,2,2
3988,KOR,Athletics,1992,1,0,0,1
3989,KOR,Judo,1992,1,1,2,4
3990,KOR,Shooting,1992,2,0,0,2
3991,KOR,Archery,1992,4,2,0,6
3992,KOR,Gymnastics,1992,0,0,1,1
3993,KOR,Handball,1992,13,0,0,13
3994,KOR,Table Tennis,1992,0,0,8,8
3995,KOR,Badminton,1992,4,1,2,7
3996,KOR,Wrestling,1996,1,3,0,4
3997,KOR,Boxing,1996,0,1,0,1
3998,KOR,Athletics,1996,0,1,0,1
3999,KOR,Judo,1996,2,4,2,8
4000,KOR,Hockey,1996,0,16,0,16
4001,KOR,Archery,1996,4,3,1,8
4002,KOR,Gymnastics,1996,0,1,0,1
4003,KOR,Handball,1996,0,16,0,16
4004,KOR,Table Tennis,1996,0,0,4,4
4005,KOR,Badminton,1996,3,4,0,7
4006,KOR,Taekwondo,2000,3,1,0,4
4007,KOR,Wrestling,2000,1,2,1,4
4008,KOR,Judo,2000,0,2,3,5
4009,KOR,Fencing,2000,1,0,1,2
4010,KOR,Shooting,2000,0,1,0,1
4011,KOR,Hockey,2000,0,16,0,16
4012,KOR,Archery,2000,7,1,1,9
4013,KOR,Baseball,2000,0,0,24,24
4014,KOR,Gymnastics,2000,0,1,1,2
4015,KOR,Table Tennis,2000,0,0,2,2
4016,KOR,Badminton,2000,0,2,2,4
4017,KOR,Taekwondo,2004,2,0,2,4
4018,KOR,Weightlifting,2004,0,2,0,2
4019,KOR,Wrestling,2004,1,1,0,2
4020,KOR,Boxing,2004,0,0,2,2
4021,KOR,Judo,2004,1,1,1,3
4022,KOR,Shooting,2004,0,2,1,3
4023,KOR,Archery,2004,7,1,0,8
4024,KOR,Gymnastics,2004,0,1,1,2
4025,KOR,Handball,2004,0,15,0,15
4026,KOR,Table Tennis,2004,1,2,1,4
4027,KOR,Badminton,2004,2,3,2,7
4028,KOR,Taekwondo,2008,4,0,0,4
4029,KOR,Weightlifting,2008,2,1,0,3
4030,KOR,Wrestling,2008,0,0,1,1
4031,KOR,Boxing,2008,0,0,1,1
4032,KOR,Judo,2008,1,2,1,4
4033,KOR,Swimming,2008,1,1,0,2
4034,KOR,Fencing,2008,0,1,0,1
4035,KOR,Shooting,2008,1,1,0,2
4036,KOR,Archery,2008,6,2,1,9
4037,KOR,Baseball,2008,24,0,0,24
4038,KOR,Gymnastics,2008,0,1,0,1
4039,KOR,Handball,2008,0,0,14,14
4040,KOR,Table Tennis,2008,0,0,6,6
4041,KOR,Badminton,2008,2,2,2,6
4042,KOR,Taekwondo,2012,1,1,0,2
4043,KOR,Wrestling,2012,1,0,0,1
4044,KOR,Boxing,2012,0,1,0,1
4045,KOR,Judo,2012,2,0,1,3
4046,KOR,Swimming,2012,0,2,0,2
4047,KOR,Fencing,2012,5,4,6,15
4048,KOR,Football,2012,0,0,18,18
4049,KOR,Shooting,2012,3,2,0,5
4050,KOR,Archery,2012,5,0,3,8
4051,KOR,Gymnastics,2012,1,0,0,1
4052,KOR,Table Tennis,2012,0,3,0,3
4053,KOR,Badminton,2012,0,0,2,2
4054,KOR,Taekwondo,2016,2,0,3,5
4055,KOR,Weightlifting,2016,0,0,1,1
4056,KOR,Wrestling,2016,0,0,1,1
4057,KOR,Judo,2016,0,2,1,3
4058,KOR,Fencing,2016,1,0,1,2
4059,KOR,Shooting,2016,1,1,0,2
4060,KOR,Archery,2016,8,0,1,9
4061,KOR,Golf,2016,1,0,0,1
4062,KOR,Badminton,2016,0,0,2,2
4063,KOR,Taekwondo,2020,0,1,2,3
4064,KOR,Judo,2020,0,1,2,3
4065,KOR,Artistic Gymnastics,2020,1,0,1,2
4066,KOR,Fencing,2020,4,4,9,17
4067,KOR,Shooting,2020,0,1,0,1
4068,KOR,Archery,2020,9,0,0,9
4069,KOR,Modern Pentathlon,2020,0,0,1,1
4070,KOR,Badminton,2020,0,0,2,2
4071,KOR,Taekwondo,2024,2,0,1,3
4072,KOR,Weightlifting,2024,0,1,0,1
4073,KOR,Boxing,2024,0,0,1,1
4074,KOR,Judo,2024,0,2,13,15
4075,KOR,Swimming,2024,0,0,1,1
4076,KOR,Fencing,2024,5,4,0,9
4077,KOR,Shooting,2024,3,4,0,7
4078,KOR,Archery,2024,10,1,1,12
4079,KOR,Modern Pentathlon,2024,0,0,1,1
4080,KOR,Table Tennis,2024,0,0,5,5
4081,KOR,Badminton,2024,1,2,0,3
4082,KOS,Judo,2016,1,0,0,1
4083,KOS,Judo,2020,2,0,0,2
4084,KOS,Judo,2024,0,1,1,2
4085,KSA,Athletics,2000,0,1,0,1
4086,KSA,Equestrianism,2000,0,0,1,1
4087,KSA,Equestrianism,2012,0,0,4,4
4088,KSA,Karate,2020,0,1,0,1
4089,KUW,Shooting,2000,0,0,1,1
4090,KUW,Shooting,2012,0,0,1,1
4091,KUW,Shooting,2020,0,0,1,1
4092,LAT,Athletics,1932,0,1,0,1
4093,LAT,Wrestling,1936,0,1,0,1
4094,LAT,Athletics,1936,0,0,1,1
4095,LAT,Shooting,1992,0,1,0,1
4096,LAT,Cycling,1992,0,0,1,1
4097,LAT,Canoeing,1992,0,1,0,1
4098,LAT,Canoeing,1996,0,1,0,1
4099,LAT,Athletics,2000,0,1,0,1
4100,LAT,Judo,2000,0,0,1,1
4101,LAT,Gymnastics,2000,1,0,0,1
4102,LAT,Weightlifting,2004,0,1,0,1
4103,LAT,Athletics,2004,0,1,0,1
4104,LAT,Modern Pentathlon,2004,0,1,0,1
4105,LAT,Gymnastics,2004,0,1,0,1
4106,LAT,Weightlifting,2008,0,0,1,1
4107,LAT,Athletics,2008,0,1,0,1
4108,LAT,Cycling,2008,1,0,0,1
4109,LAT,Cycling,2012,1,0,0,1
4110,LAT,Beach Volleyball,2012,0,0,2,2
4111,LAT,Weightlifting,2020,0,0,1,1
4112,LAT,3x3 Basketball,2020,4,0,0,4
4113,LCA,Athletics,2024,1,1,0,2
4114,LIB,Wrestling,1952,0,1,1,2
4115,LIB,Weightlifting,1972,0,1,0,1
4116,LIB,Wrestling,1980,0,0,1,1
4117,LTU,Athletics,1992,1,0,0,1
4118,LTU,Basketball,1992,0,0,12,12
4119,LTU,Basketball,1996,0,0,11,11
4120,LTU,Rowing,2000,0,0,2,2
4121,LTU,Athletics,2000,1,0,0,1
4122,LTU,Shooting,2000,1,0,0,1
4123,LTU,Basketball,2000,0,0,12,12
4124,LTU,Cycling,2000,0,0,1,1
4125,LTU,Athletics,2004,1,1,0,2
4126,LTU,Modern Pentathlon,2004,0,1,0,1
4127,LTU,Sailing,2008,0,1,0,1
4128,LTU,Wrestling,2008,0,0,1,1
4129,LTU,Athletics,2008,0,0,1,1
4130,LTU,Modern Pentathlon,2008,0,1,1,2
4131,LTU,Wrestling,2012,0,0,1,1
4132,LTU,Boxing,2012,0,0,1,1
4133,LTU,Swimming,2012,1,0,0,1
4134,LTU,Canoeing,2012,0,1,0,1
4135,LTU,Modern Pentathlon,2012,1,0,0,1
4136,LTU,Rowing,2016,0,2,2,4
4137,LTU,Weightlifting,2016,0,0,1,1
4138,LTU,Canoeing,2016,0,0,2,2
4139,LTU,Modern Pentathlon,2020,0,1,0,1
4140,LTU,Rowing,2024,0,0,1,1
4141,LTU,Athletics,2024,0,1,0,1
4142,LTU,Breaking,2024,0,1,0,1
4143,LTU,3x3 Basketball,2024,0,0,4,4
4144,LUX,Athletics,1900,1,0,0,1
4145,LUX,Weightlifting,1920,0,1,0,1
4146,LUX,Art Competitions,1924,1,1,0,2
4147,LUX,Art Competitions,1928,1,0,0,1
4148,LUX,Athletics,1952,1,0,0,1
4149,MAR,Athletics,1960,0,1,0,1
4150,MAR,Athletics,1984,2,0,0,2
4151,MAR,Boxing,1988,0,0,1,1
4152,MAR,Athletics,1988,1,0,1,2
4153,MAR,Boxing,1992,0,0,1,1
4154,MAR,Athletics,1992,1,1,0,2
4155,MAR,Athletics,1996,0,0,2,2
4156,MAR,Boxing,2000,0,0,1,1
4157,MAR,Athletics,2000,0,1,3,4
4158,MAR,Athletics,2004,2,1,0,3
4159,MAR,Athletics,2008,0,1,1,2
4160,MAR,Athletics,2012,0,0,1,1
4161,MAR,Boxing,2016,0,0,1,1
4162,MAR,Athletics,2020,1,0,0,1
4163,MAR,Athletics,2024,1,0,0,1
4164,MAR,Football,2024,0,0,19,19
4165,MAS,Badminton,1992,0,0,2,2
4166,MAS,Badminton,1996,0,2,1,3
4167,MAS,Badminton,2008,0,1,0,1
4168,MAS,Diving,2012,0,0,1,1
4169,MAS,Badminton,2012,0,1,0,1
4170,MAS,Cycling,2016,0,0,1,1
4171,MAS,Diving,2016,0,2,0,2
4172,MAS,Badminton,2016,0,5,0,5
4173,MAS,Cycling Track,2020,0,1,0,1
4174,MAS,Badminton,2020,0,0,2,2
4175,MAS,Badminton,2024,0,0,3,3
4176,MDA,Wrestling,1996,0,0,1,1
4177,MDA,Canoeing,1996,0,2,0,2
4178,MDA,Boxing,2000,0,0,1,1
4179,MDA,Shooting,2000,0,1,0,1
4180,MDA,Boxing,2008,0,0,1,1
4181,MDA,Weightlifting,2012,0,0,2,2
4182,MDA,Canoe Sprint,2020,0,0,1,1
4183,MDA,Wrestling,2024,0,1,0,1
4184,MDA,Judo,2024,0,0,2,2
4185,MDA,Canoe Sprint,2024,0,0,1,1
4186,MEX,Polo,1900,0,0,3,3
4187,MEX,Boxing,1932,0,1,0,1
4188,MEX,Shooting,1932,0,1,0,1
4189,MEX,Boxing,1936,0,0,1,1
4190,MEX,Polo,1936,0,0,4,4
4191,MEX,Basketball,1936,0,0,11,11
4192,MEX,Equestrianism,1948,4,1,3,8
4193,MEX,Diving,1948,0,0,1,1
4194,MEX,Diving,1952,0,1,0,1
4195,MEX,Diving,1956,1,0,1,2
4196,MEX,Diving,1960,0,0,1,1
4197,MEX,Boxing,1964,0,0,1,1
4198,MEX,Boxing,1968,2,0,2,4
4199,MEX,Athletics,1968,0,1,0,1
4200,MEX,Swimming,1968,1,0,1,2
4201,MEX,Fencing,1968,0,1,0,1
4202,MEX,Diving,1968,0,1,0,1
4203,MEX,Boxing,1972,0,1,0,1
4204,MEX,Boxing,1976,0,0,1,1
4205,MEX,Athletics,1976,1,0,0,1
4206,MEX,Equestrianism,1980,0,0,9,9
4207,MEX,Diving,1980,0,1,0,1
4208,MEX,Wrestling,1984,0,1,0,1
4209,MEX,Boxing,1984,0,1,0,1
4210,MEX,Athletics,1984,2,1,0,3
4211,MEX,Cycling,1984,0,0,1,1
4212,MEX,Boxing,1988,0,0,1,1
4213,MEX,Diving,1988,0,0,1,1
4214,MEX,Athletics,1992,0,1,0,1
4215,MEX,Athletics,1996,0,0,1,1
4216,MEX,Taekwondo,2000,0,0,1,1
4217,MEX,Weightlifting,2000,1,0,0,1
4218,MEX,Boxing,2000,0,0,1,1
4219,MEX,Athletics,2000,0,1,1,2
4220,MEX,Diving,2000,0,1,0,1
4221,MEX,Taekwondo,2004,0,1,1,2
4222,MEX,Athletics,2004,0,1,0,1
4223,MEX,Cycling,2004,0,1,0,1
4224,MEX,Taekwondo,2008,2,0,0,2
4225,MEX,Diving,2008,0,0,2,2
4226,MEX,Taekwondo,2012,0,0,1,1
4227,MEX,Football,2012,16,0,0,16
4228,MEX,Diving,2012,0,4,1,5
4229,MEX,Archery,2012,0,1,1,2
4230,MEX,Taekwondo,2016,0,1,0,1
4231,MEX,Boxing,2016,0,0,1,1
4232,MEX,Athletics,2016,0,1,0,1
4233,MEX,Diving,2016,0,1,0,1
4234,MEX,Modern Pentathlon,2016,0,0,1,1
4235,MEX,Weightlifting,2020,0,0,1,1
4236,MEX,Football,2020,0,0,22,22
4237,MEX,Diving,2020,0,0,2,2
4238,MEX,Archery,2020,0,0,2,2
4239,MEX,Boxing,2024,0,1,0,1
4240,MEX,Judo,2024,0,1,0,1
4241,MEX,Diving,2024,0,2,1,3
4242,MEX,Archery,2024,0,0,3,3
4243,MGL,Wrestling,1968,0,1,3,4
4244,MGL,Wrestling,1972,0,1,0,1
4245,MGL,Wrestling,1976,0,1,0,1
4246,MGL,Wrestling,1980,0,1,1,2
4247,MGL,Judo,1980,0,1,1,2
4248,MGL,Boxing,1988,0,0,1,1
4249,MGL,Boxing,1992,0,0,1,1
4250,MGL,Shooting,1992,0,0,1,1
4251,MGL,Judo,1996,0,0,1,1
4252,MGL,Judo,2004,0,0,1,1
4253,MGL,Boxing,2008,1,1,0,2
4254,MGL,Judo,2008,1,0,0,1
4255,MGL,Shooting,2008,0,1,0,1
4256,MGL,Wrestling,2012,0,0,1,1
4257,MGL,Boxing,2012,0,1,1,2
4258,MGL,Judo,2012,0,1,1,2
4259,MGL,Boxing,2016,0,0,1,1
4260,MGL,Judo,2016,0,1,0,1
4261,MGL,Wrestling,2020,0,0,1,1
4262,MGL,Judo,2020,0,1,2,3
4263,MGL,Judo,2024,0,1,0,1
4264,MKD,Wrestling,2000,0,0,1,1
4265,MKD,Taekwondo,2020,0,1,0,1
4266,MNE,Handball,2012,0,14,0,14
4267,MON,Art Competitions,1924,0,0,1,1
4268,MOZ,Athletics,1996,0,0,1,1
4269,MOZ,Athletics,2000,1,0,0,1
4270,MRI,Boxing,2008,0,0,1,1
4271,NAM,Athletics,1992,0,2,0,2
4272,NAM,Athletics,1996,0,2,0,2
4273,NAM,Athletics,2020,0,1,0,1
4274,NED,Sailing,1900,0,3,0,3
4275,NED,Rowing,1900,3,5,9,17
4276,NED,Swimming,1900,0,0,1,1
4277,NED,Football,1900,0,0,1,1
4278,NED,Shooting,1900,0,0,5,5
4279,NED,Fencing,1906,0,1,5,6
4280,NED,Rowing,1908,0,0,4,4
4281,NED,Football,1908,0,0,12,12
4282,NED,Fencing,1912,0,0,11,11
4283,NED,Football,1912,0,0,15,15
4284,NED,Sailing,1920,6,2,0,8
4285,NED,Fencing,1920,0,0,8,8
4286,NED,Football,1920,0,0,14,14
4287,NED,Cycling,1920,1,0,3,4
4288,NED,Archery,1920,8,0,0,8
4289,NED,Tug-Of-War,1920,0,8,0,8
4290,NED,Sailing,1924,0,0,3,3
4291,NED,Rowing,1924,2,0,0,2
4292,NED,Tennis,1924,0,0,2,2
4293,NED,Athletics,1924,0,0,4,4
4294,NED,Fencing,1924,0,0,6,6
4295,NED,Equestrianism,1924,5,0,0,5
4296,NED,Cycling,1924,1,1,2,4
4297,NED,Art Competitions,1924,0,0,1,1
4298,NED,Sailing,1928,0,6,0,6
4299,NED,Weightlifting,1928,0,0,2,2
4300,NED,Boxing,1928,1,0,1,2
4301,NED,Athletics,1928,0,1,0,1
4302,NED,Swimming,1928,1,2,0,3
4303,NED,Equestrianism,1928,4,1,3,8
4304,NED,Hockey,1928,0,11,0,11
4305,NED,Cycling,1928,2,7,0,9
4306,NED,Gymnastics,1928,10,0,0,10
4307,NED,Art Competitions,1928,2,1,2,5
4308,NED,Sailing,1932,0,1,0,1
4309,NED,Swimming,1932,0,5,0,5
4310,NED,Equestrianism,1932,1,3,0,4
4311,NED,Cycling,1932,1,1,0,2
4312,NED,Art Competitions,1932,0,0,1,1
4313,NED,Sailing,1936,1,0,2,3
4314,NED,Athletics,1936,0,0,2,2
4315,NED,Swimming,1936,7,1,0,8
4316,NED,Equestrianism,1936,0,3,0,3
4317,NED,Hockey,1936,0,0,12,12
4318,NED,Cycling,1936,1,3,0,4
4319,NED,Canoeing,1936,0,0,5,5
4320,NED,Sailing,1948,0,0,3,3
4321,NED,Weightlifting,1948,0,0,1,1
4322,NED,Athletics,1948,7,0,2,9
4323,NED,Swimming,1948,1,0,5,6
4324,NED,Hockey,1948,0,0,12,12
4325,NED,Cycling,1948,0,1,0,1
4326,NED,Canoeing,1948,0,1,0,1
4327,NED,Water Polo,1948,0,0,9,9
4328,NED,Athletics,1952,0,1,0,1
4329,NED,Swimming,1952,0,6,0,6
4330,NED,Hockey,1952,0,11,0,11
4331,NED,Swimming,1960,0,1,2,3
4332,NED,Rowing,1964,0,2,8,10
4333,NED,Judo,1964,1,0,0,1
4334,NED,Swimming,1964,0,6,4,10
4335,NED,Cycling,1964,4,0,4,8
4336,NED,Canoeing,1964,0,2,0,2
4337,NED,Rowing,1968,1,5,0,6
4338,NED,Athletics,1968,0,0,1,1
4339,NED,Swimming,1968,1,0,0,1
4340,NED,Cycling,1968,4,2,0,6
4341,NED,Rowing,1972,0,0,2,2
4342,NED,Judo,1972,2,0,0,2
4343,NED,Cycling,1972,1,0,0,1
4344,NED,Canoeing,1972,0,1,0,1
4345,NED,Swimming,1976,0,0,2,2
4346,NED,Shooting,1976,0,1,0,1
4347,NED,Cycling,1976,0,1,0,1
4348,NED,Water Polo,1976,0,0,10,10
4349,NED,Athletics,1980,0,1,0,1
4350,NED,Judo,1980,0,0,1,1
4351,NED,Swimming,1980,0,0,4,4
4352,NED,Sailing,1984,1,0,0,1
4353,NED,Rowing,1984,0,2,9,11
4354,NED,Boxing,1984,0,0,1,1
4355,NED,Athletics,1984,1,0,0,1
4356,NED,Swimming,1984,2,5,3,10
4357,NED,Hockey,1984,16,0,0,16
4358,NED,Canoeing,1984,0,0,1,1
4359,NED,Rowing,1988,2,0,0,2
4360,NED,Boxing,1988,0,0,1,1
4361,NED,Judo,1988,0,0,1,1
4362,NED,Swimming,1988,0,5,0,5
4363,NED,Hockey,1988,0,0,32,32
4364,NED,Cycling,1988,1,1,0,2
4365,NED,Canoeing,1988,0,0,2,2
4366,NED,Sailing,1992,0,0,1,1
4367,NED,Rowing,1992,0,0,2,2
4368,NED,Boxing,1992,0,1,1,2
4369,NED,Athletics,1992,1,0,0,1
4370,NED,Judo,1992,0,0,2,2
4371,NED,Equestrianism,1992,4,5,0,9
4372,NED,Volleyball,1992,0,12,0,12
4373,NED,Cycling,1992,0,2,2,4
4374,NED,Sailing,1996,0,1,1,2
4375,NED,Rowing,1996,9,2,2,13
4376,NED,Judo,1996,0,0,3,3
4377,NED,Swimming,1996,0,0,2,2
4378,NED,Equestrianism,1996,0,5,1,6
4379,NED,Volleyball,1996,12,0,0,12
4380,NED,Hockey,1996,16,0,16,32
4381,NED,Cycling,1996,1,1,1,3
4382,NED,Sailing,2000,0,1,0,1
4383,NED,Rowing,2000,0,15,0,15
4384,NED,Tennis,2000,0,2,0,2
4385,NED,Judo,2000,1,0,0,1
4386,NED,Swimming,2000,5,5,6,16
4387,NED,Equestrianism,2000,2,5,0,7
4388,NED,Hockey,2000,16,0,16,32
4389,NED,Cycling,2000,3,1,0,4
4390,NED,Archery,2000,0,0,1,1
4391,NED,Rowing,2004,0,9,11,20
4392,NED,Judo,2004,0,1,3,4
4393,NED,Swimming,2004,2,7,6,15
4394,NED,Equestrianism,2004,1,0,0,1
4395,NED,Hockey,2004,0,32,0,32
4396,NED,Cycling,2004,1,1,2,4
4397,NED,Badminton,2004,0,1,0,1
4398,NED,Sailing,2008,0,5,0,5
4399,NED,Rowing,2008,2,9,0,11
4400,NED,Judo,2008,0,1,4,5
4401,NED,Swimming,2008,7,0,0,7
4402,NED,Equestrianism,2008,1,3,0,4
4403,NED,Hockey,2008,16,0,0,16
4404,NED,Cycling,2008,1,0,0,1
4405,NED,Water Polo,2008,12,0,0,12
4406,NED,Sailing,2012,1,1,2,4
4407,NED,Rowing,2012,0,0,9,9
4408,NED,Judo,2012,0,0,2,2
4409,NED,Swimming,2012,2,5,1,8
4410,NED,Equestrianism,2012,0,6,3,9
4411,NED,Hockey,2012,16,17,0,33
4412,NED,Cycling,2012,1,0,2,3
4413,NED,Gymnastics,2012,1,0,0,1
4414,NED,Sailing,2016,2,0,0,2
4415,NED,Rowing,2016,2,4,9,15
4416,NED,Boxing,2016,0,1,0,1
4417,NED,Athletics,2016,0,1,0,1
4418,NED,Judo,2016,0,0,1,1
4419,NED,Swimming,2016,2,0,0,2
4420,NED,Hockey,2016,0,16,0,16
4421,NED,Cycling,2016,2,3,1,6
4422,NED,Beach Volleyball,2016,0,0,2,2
4423,NED,Gymnastics,2016,1,0,0,1
4424,NED,Sailing,2020,1,0,3,4
4425,NED,Rowing,2020,4,6,4,14
4426,NED,Boxing,2020,0,0,1,1
4427,NED,Athletics,2020,2,8,3,13
4428,NED,Judo,2020,0,0,1,1
4429,NED,Swimming,2020,0,2,0,2
4430,NED,Hockey,2020,18,0,0,18
4431,NED,Archery,2020,0,2,0,2
4432,NED,Cycling Road,2020,1,2,1,4
4433,NED,Cycling Track,2020,6,1,2,9
4434,NED,Equestrian,2020,0,0,1,1
4435,NED,Marathon Swimming,2020,0,1,0,1
4436,NED,Cycling BMX Racing,2020,1,0,1,2
4437,NED,Sailing,2024,3,0,2,5
4438,NED,Rowing,2024,11,15,1,27
4439,NED,Athletics,2024,7,7,3,17
4440,NED,Swimming,2024,0,0,2,2
4441,NED,Hockey,2024,35,0,0,35
4442,NED,Water Polo,2024,0,0,13,13
4443,NED,Cycling Road,2024,0,1,0,1
4444,NED,Cycling Track,2024,6,1,2,9
4445,NED,Equestrian,2024,0,0,1,1
4446,NED,Marathon Swimming,2024,1,0,0,1
4447,NED,Cycling BMX Racing,2024,0,1,0,1
4448,NED,3x3 Basketball,2024,4,0,0,4
4449,NED,Artistic Swimming,2024,0,0,2,2
4450,NGR,Boxing,1964,0,0,1,1
4451,NGR,Boxing,1972,0,0,1,1
4452,NGR,Boxing,1984,0,1,0,1
4453,NGR,Athletics,1984,0,0,4,4
4454,NGR,Boxing,1992,0,2,0,2
4455,NGR,Athletics,1992,0,5,4,9
4456,NGR,Boxing,1996,0,0,1,1
4457,NGR,Athletics,1996,1,4,2,7
4458,NGR,Football,1996,16,0,0,16
4459,NGR,Weightlifting,2000,0,1,0,1
4460,NGR,Athletics,2000,6,1,0,7
4461,NGR,Athletics,2004,0,0,8,8
4462,NGR,Taekwondo,2008,0,0,1,1
4463,NGR,Athletics,2008,0,0,6,6
4464,NGR,Football,2008,0,16,0,16
4465,NGR,Football,2016,0,0,18,18
4466,NGR,Wrestling,2020,0,1,0,1
4467,NGR,Athletics,2020,0,0,1,1
4468,NIG,Boxing,1972,0,0,1,1
4469,NIG,Taekwondo,2016,0,1,0,1
4470,NOR,Athletics,1900,0,0,1,1
4471,NOR,Shooting,1900,0,6,2,8
4472,NOR,Wrestling,1904,2,0,0,2
4473,NOR,Shooting,1906,0,5,0,5
4474,NOR,Gymnastics,1906,20,0,0,20
4475,NOR,Wrestling,1908,0,1,0,1
4476,NOR,Athletics,1908,0,1,2,3
4477,NOR,Shooting,1908,7,0,1,8
4478,NOR,Gymnastics,1908,0,30,0,30
4479,NOR,Sailing,1912,15,0,0,15
4480,NOR,Rowing,1912,0,0,10,10
4481,NOR,Tennis,1912,0,0,1,1
4482,NOR,Athletics,1912,1,0,0,1
4483,NOR,Shooting,1912,0,6,1,7
4484,NOR,Gymnastics,1912,24,0,22,46
4485,NOR,Sailing,1920,44,12,3,59
4486,NOR,Rowing,1920,0,0,14,14
4487,NOR,Wrestling,1920,0,0,1,1
4488,NOR,Boxing,1920,0,1,0,1
4489,NOR,Athletics,1920,1,0,0,1
4490,NOR,Shooting,1920,13,10,8,31
4491,NOR,Gymnastics,1920,0,25,0,25
4492,NOR,Art Competitions,1920,0,1,0,1
4493,NOR,Figure Skating,1920,0,3,1,4
4494,NOR,Sailing,1924,8,1,0,9
4495,NOR,Boxing,1924,1,0,1,2
4496,NOR,Athletics,1924,0,0,1,1
4497,NOR,Shooting,1924,5,4,1,10
4498,NOR,Sailing,1928,4,1,0,5
4499,NOR,Athletics,1928,0,0,1,1
4500,NOR,Equestrianism,1928,0,3,0,3
4501,NOR,Sailing,1936,0,11,0,11
4502,NOR,Boxing,1936,0,1,1,2
4503,NOR,Football,1936,0,0,14,14
4504,NOR,Shooting,1936,1,0,0,1
4505,NOR,Sailing,1948,3,0,0,3
4506,NOR,Rowing,1948,0,0,9,9
4507,NOR,Wrestling,1948,0,1,0,1
4508,NOR,Athletics,1948,0,1,0,1
4509,NOR,Shooting,1948,0,0,1,1
4510,NOR,Canoeing,1948,0,2,1,3
4511,NOR,Sailing,1952,3,8,0,11
4512,NOR,Shooting,1952,2,0,0,2
4513,NOR,Athletics,1956,1,0,2,3
4514,NOR,Sailing,1960,2,0,0,2
4515,NOR,Sailing,1968,0,2,0,2
4516,NOR,Canoeing,1968,4,0,0,4
4517,NOR,Rowing,1972,0,2,0,2
4518,NOR,Weightlifting,1972,1,0,0,1
4519,NOR,Cycling,1972,1,0,0,1
4520,NOR,Canoeing,1972,0,0,4,4
4521,NOR,Rowing,1976,2,4,0,6
4522,NOR,Rowing,1984,0,0,2,2
4523,NOR,Athletics,1984,0,1,0,1
4524,NOR,Cycling,1984,0,0,1,1
4525,NOR,Sailing,1988,0,2,0,2
4526,NOR,Rowing,1988,0,4,0,4
4527,NOR,Wrestling,1988,1,0,0,1
4528,NOR,Shooting,1988,1,0,0,1
4529,NOR,Handball,1988,0,14,0,14
4530,NOR,Sailing,1992,1,0,0,1
4531,NOR,Rowing,1992,0,4,0,4
4532,NOR,Wrestling,1992,1,0,0,1
4533,NOR,Shooting,1992,0,1,0,1
4534,NOR,Canoeing,1992,0,1,1,2
4535,NOR,Handball,1992,0,14,0,14
4536,NOR,Sailing,1996,0,0,1,1
4537,NOR,Rowing,1996,0,2,0,2
4538,NOR,Athletics,1996,1,0,1,2
4539,NOR,Football,1996,0,0,16,16
4540,NOR,Canoeing,1996,1,1,0,2
4541,NOR,Taekwondo,2000,0,1,0,1
4542,NOR,Sailing,2000,0,0,3,3
4543,NOR,Rowing,2000,0,2,0,2
4544,NOR,Athletics,2000,1,1,0,2
4545,NOR,Football,2000,17,0,0,17
4546,NOR,Shooting,2000,0,0,1,1
4547,NOR,Canoeing,2000,2,0,0,2
4548,NOR,Handball,2000,0,0,15,15
4549,NOR,Sailing,2004,1,0,0,1
4550,NOR,Rowing,2004,1,0,0,1
4551,NOR,Athletics,2004,1,0,0,1
4552,NOR,Cycling,2004,1,0,0,1
4553,NOR,Canoeing,2004,1,0,2,3
4554,NOR,Taekwondo,2008,0,1,0,1
4555,NOR,Rowing,2008,1,0,0,1
4556,NOR,Athletics,2008,1,1,0,2
4557,NOR,Swimming,2008,0,1,1,2
4558,NOR,Shooting,2008,0,1,0,1
4559,NOR,Canoeing,2008,0,1,0,1
4560,NOR,Handball,2008,14,0,0,14
4561,NOR,Fencing,2012,0,1,0,1
4562,NOR,Cycling,2012,0,0,1,1
4563,NOR,Canoeing,2012,1,0,0,1
4564,NOR,Handball,2012,14,0,0,14
4565,NOR,Rowing,2016,0,0,4,4
4566,NOR,Wrestling,2016,0,0,1,1
4567,NOR,Handball,2016,0,0,14,14
4568,NOR,Sailing,2020,0,0,1,1
4569,NOR,Rowing,2020,0,1,0,1
4570,NOR,Athletics,2020,2,1,0,3
4571,NOR,Beach Volleyball,2020,2,0,0,2
4572,NOR,Triathlon,2020,1,0,0,1
4573,NOR,Handball,2020,0,0,15,15
4574,NOR,Sailing,2024,0,0,1,1
4575,NOR,Weightlifting,2024,1,0,0,1
4576,NOR,Wrestling,2024,0,0,1,1
4577,NOR,Athletics,2024,2,1,0,3
4578,NOR,Beach Volleyball,2024,0,0,2,2
4579,NOR,Handball,2024,15,0,0,15
4580,NZL,Water Polo,1900,1,0,0,1
4581,NZL,Rowing,1920,0,0,1,1
4582,NZL,Athletics,1924,0,0,1,1
4583,NZL,Boxing,1928,1,0,0,1
4584,NZL,Rowing,1932,0,2,0,2
4585,NZL,Athletics,1936,1,0,0,1
4586,NZL,Athletics,1952,1,0,1,2
4587,NZL,Swimming,1952,0,0,1,1
4588,NZL,Sailing,1956,2,0,0,2
4589,NZL,Athletics,1956,1,0,0,1
4590,NZL,Athletics,1960,2,0,1,3
4591,NZL,Sailing,1964,2,0,0,2
4592,NZL,Athletics,1964,2,0,2,4
4593,NZL,Rowing,1968,5,0,0,5
4594,NZL,Athletics,1968,0,0,1,1
4595,NZL,Shooting,1968,0,0,1,1
4596,NZL,Rowing,1972,9,4,0,13
4597,NZL,Athletics,1972,0,0,1,1
4598,NZL,Rowing,1976,0,0,9,9
4599,NZL,Athletics,1976,1,1,0,2
4600,NZL,Hockey,1976,14,0,0,14
4601,NZL,Sailing,1984,3,0,1,4
4602,NZL,Rowing,1984,4,0,5,9
4603,NZL,Boxing,1984,0,1,0,1
4604,NZL,Equestrianism,1984,1,0,0,1
4605,NZL,Canoeing,1984,8,0,0,8
4606,NZL,Sailing,1988,1,2,1,4
4607,NZL,Rowing,1988,0,0,8,8
4608,NZL,Swimming,1988,0,0,2,2
4609,NZL,Equestrianism,1988,1,0,4,5
4610,NZL,Canoeing,1988,2,2,1,5
4611,NZL,Sailing,1992,1,4,1,6
4612,NZL,Boxing,1992,0,0,1,1
4613,NZL,Athletics,1992,0,0,1,1
4614,NZL,Swimming,1992,0,1,0,1
4615,NZL,Equestrianism,1992,0,4,1,5
4616,NZL,Cycling,1992,0,0,1,1
4617,NZL,Sailing,1996,0,1,0,1
4618,NZL,Swimming,1996,2,0,0,2
4619,NZL,Equestrianism,1996,1,1,4,6
4620,NZL,Sailing,2000,0,0,2,2
4621,NZL,Rowing,2000,1,0,0,1
4622,NZL,Equestrianism,2000,0,0,1,1
4623,NZL,Rowing,2004,2,0,0,2
4624,NZL,Cycling,2004,1,0,0,1
4625,NZL,Canoeing,2004,0,1,0,1
4626,NZL,Triathlon,2004,1,1,0,2
4627,NZL,Sailing,2008,1,0,0,1
4628,NZL,Rowing,2008,2,0,3,5
4629,NZL,Athletics,2008,1,1,0,2
4630,NZL,Cycling,2008,0,1,5,6
4631,NZL,Triathlon,2008,0,0,1,1
4632,NZL,Sailing,2012,2,2,0,4
4633,NZL,Rowing,2012,5,0,4,9
4634,NZL,Athletics,2012,1,0,0,1
4635,NZL,Equestrianism,2012,0,0,5,5
4636,NZL,Cycling,2012,0,1,6,7
4637,NZL,Canoeing,2012,1,0,0,1
4638,NZL,Sailing,2016,2,4,1,7
4639,NZL,Rowing,2016,3,2,0,5
4640,NZL,Athletics,2016,0,1,3,4
4641,NZL,Shooting,2016,0,1,0,1
4642,NZL,Cycling,2016,0,3,0,3
4643,NZL,Rugby Sevens,2016,0,12,0,12
4644,NZL,Canoeing,2016,1,1,1,3
4645,NZL,Golf,2016,0,1,0,1
4646,NZL,Sailing,2020,0,2,0,2
4647,NZL,Rowing,2020,12,11,0,23
4648,NZL,Tennis,2020,0,0,2,2
4649,NZL,Trampoline Gymnastics,2020,0,0,1,1
4650,NZL,Boxing,2020,0,0,1,1
4651,NZL,Athletics,2020,0,0,2,2
4652,NZL,Rugby Sevens,2020,13,13,0,26
4653,NZL,Triathlon,2020,0,0,1,1
4654,NZL,Canoe Sprint,2020,4,0,0,4
4655,NZL,Cycling Track,2020,0,2,0,2
4656,NZL,Golf,2020,0,0,1,1
4657,NZL,Sailing,2024,0,2,2,4
4658,NZL,Rowing,2024,2,5,4,11
4659,NZL,Athletics,2024,1,1,0,2
4660,NZL,Rugby Sevens,2024,12,0,0,12
4661,NZL,Triathlon,2024,0,1,0,1
4662,NZL,Canoe Slalom,2024,1,0,0,1
4663,NZL,Canoe Sprint,2024,7,0,0,7
4664,NZL,Cycling Track,2024,2,9,1,12
4665,NZL,Golf,2024,1,0,0,1
4666,PAK,Hockey,1956,0,14,0,14
4667,PAK,Wrestling,1960,0,0,1,1
4668,PAK,Hockey,1960,13,0,0,13
4669,PAK,Hockey,1964,0,16,0,16
4670,PAK,Hockey,1968,13,0,0,13
4671,PAK,Hockey,1972,0,15,0,15
4672,PAK,Hockey,1976,0,0,16,16
4673,PAK,Hockey,1984,16,0,0,16
4674,PAK,Boxing,1988,0,0,1,1
4675,PAK,Hockey,1992,0,0,16,16
4676,PAK,Athletics,2024,1,0,0,1
4677,PAN,Athletics,1948,0,0,2,2
4678,PAN,Athletics,2008,1,0,0,1
4679,PAN,Boxing,2024,0,1,0,1
4680,PAR,Football,2004,0,17,0,17
4681,PER,Shooting,1948,1,0,0,1
4682,PER,Shooting,1984,0,1,0,1
4683,PER,Volleyball,1988,0,12,0,12
4684,PER,Shooting,1992,0,1,0,1
4685,PER,Sailing,2024,0,0,1,1
4686,PHI,Swimming,1928,0,0,1,1
4687,PHI,Boxing,1932,0,0,1,1
4688,PHI,Athletics,1932,0,0,1,1
4689,PHI,Swimming,1932,0,0,1,1
4690,PHI,Athletics,1936,0,0,1,1
4691,PHI,Boxing,1964,0,1,0,1
4692,PHI,Boxing,1988,0,0,1,1
4693,PHI,Boxing,1992,0,0,1,1
4694,PHI,Boxing,1996,0,1,0,1
4695,PHI,Weightlifting,2016,0,1,0,1
4696,PHI,Weightlifting,2020,1,0,0,1
4697,PHI,Boxing,2020,0,2,1,3
4698,PHI,Boxing,2024,0,0,2,2
4699,PHI,Artistic Gymnastics,2024,2,0,0,2
4700,POL,Equestrianism,1924,0,0,1,1
4701,POL,Cycling,1924,0,4,0,4
4702,POL,Rowing,1928,0,0,5,5
4703,POL,Athletics,1928,1,0,0,1
4704,POL,Fencing,1928,0,0,6,6
4705,POL,Equestrianism,1928,0,3,3,6
4706,POL,Art Competitions,1928,1,0,1,2
4707,POL,Rowing,1932,0,3,7,10
4708,POL,Athletics,1932,2,0,1,3
4709,POL,Fencing,1932,0,0,6,6
4710,POL,Art Competitions,1932,1,1,0,2
4711,POL,Rowing,1936,0,0,2,2
4712,POL,Athletics,1936,0,2,1,3
4713,POL,Shooting,1936,0,0,1,1
4714,POL,Equestrianism,1936,0,3,0,3
4715,POL,Art Competitions,1936,0,1,2,3
4716,POL,Boxing,1948,0,0,1,1
4717,POL,Art Competitions,1948,1,0,0,1
4718,POL,Rowing,1952,0,0,1,1
4719,POL,Boxing,1952,1,1,0,2
4720,POL,Gymnastics,1952,0,1,0,1
4721,POL,Weightlifting,1956,0,0,1,1
4722,POL,Boxing,1956,0,0,2,2
4723,POL,Athletics,1956,1,1,0,2
4724,POL,Fencing,1956,0,7,0,7
4725,POL,Shooting,1956,0,1,0,1
4726,POL,Gymnastics,1956,0,0,6,6
4727,POL,Rowing,1960,0,0,1,1
4728,POL,Weightlifting,1960,1,0,1,2
4729,POL,Wrestling,1960,0,0,1,1
4730,POL,Boxing,1960,1,3,3,7
4731,POL,Athletics,1960,2,2,6,10
4732,POL,Fencing,1960,0,6,0,6
4733,POL,Canoeing,1960,0,0,3,3
4734,POL,Weightlifting,1964,1,0,3,4
4735,POL,Boxing,1964,3,1,3,7
4736,POL,Athletics,1964,5,7,2,14
4737,POL,Fencing,1964,1,5,5,11
4738,POL,Volleyball,1964,0,0,10,10
4739,POL,Weightlifting,1968,1,0,4,5
4740,POL,Boxing,1968,1,2,2,5
4741,POL,Athletics,1968,1,0,1,2
4742,POL,Fencing,1968,1,0,10,11
4743,POL,Shooting,1968,1,0,0,1
4744,POL,Volleyball,1968,0,0,12,12
4745,POL,Cycling,1968,0,0,1,1
4746,POL,Weightlifting,1972,1,1,1,3
4747,POL,Wrestling,1972,0,0,2,2
4748,POL,Boxing,1972,1,1,2,4
4749,POL,Athletics,1972,1,0,2,3
4750,POL,Judo,1972,0,1,0,1
4751,POL,Fencing,1972,6,0,0,6
4752,POL,Football,1972,17,0,0,17
4753,POL,Shooting,1972,1,0,0,1
4754,POL,Cycling,1972,0,4,2,6
4755,POL,Canoeing,1972,0,0,2,2
4756,POL,Archery,1972,0,1,0,1
4757,POL,Weightlifting,1976,0,1,2,3
4758,POL,Wrestling,1976,1,0,2,3
4759,POL,Boxing,1976,1,0,4,5
4760,POL,Athletics,1976,3,5,0,8
4761,POL,Judo,1976,0,0,1,1
4762,POL,Football,1976,0,17,0,17
4763,POL,Shooting,1976,0,0,2,2
4764,POL,Volleyball,1976,12,0,0,12
4765,POL,Cycling,1976,0,4,1,5
4766,POL,Canoeing,1976,0,2,0,2
4767,POL,Modern Pentathlon,1976,1,0,0,1
4768,POL,Handball,1976,0,0,14,14
4769,POL,Rowing,1980,0,2,5,7
4770,POL,Weightlifting,1980,0,0,3,3
4771,POL,Wrestling,1980,0,5,2,7
4772,POL,Boxing,1980,0,1,4,5
4773,POL,Athletics,1980,2,7,1,10
4774,POL,Judo,1980,0,0,1,1
4775,POL,Swimming,1980,0,0,1,1
4776,POL,Fencing,1980,0,5,5,10
4777,POL,Equestrianism,1980,1,4,0,5
4778,POL,Cycling,1980,0,1,0,1
4779,POL,Weightlifting,1988,0,0,1,1
4780,POL,Wrestling,1988,1,1,1,3
4781,POL,Boxing,1988,0,0,4,4
4782,POL,Judo,1988,1,1,0,2
4783,POL,Swimming,1988,0,0,1,1
4784,POL,Fencing,1988,0,1,0,1
4785,POL,Cycling,1988,0,4,0,4
4786,POL,Canoeing,1988,0,2,3,5
4787,POL,Rowing,1992,0,0,6,6
4788,POL,Weightlifting,1992,0,1,2,3
4789,POL,Wrestling,1992,0,2,0,2
4790,POL,Boxing,1992,0,0,1,1
4791,POL,Athletics,1992,0,0,1,1
4792,POL,Judo,1992,1,0,0,1
4793,POL,Swimming,1992,0,1,0,1
4794,POL,Fencing,1992,0,0,5,5
4795,POL,Football,1992,0,16,0,16
4796,POL,Shooting,1992,0,0,1,1
4797,POL,Canoeing,1992,0,2,3,5
4798,POL,Modern Pentathlon,1992,4,0,0,4
4799,POL,Sailing,1996,1,0,0,1
4800,POL,Weightlifting,1996,0,0,1,1
4801,POL,Wrestling,1996,3,1,1,5
4802,POL,Athletics,1996,1,1,0,2
4803,POL,Judo,1996,1,1,0,2
4804,POL,Fencing,1996,0,4,0,4
4805,POL,Shooting,1996,1,1,1,3
4806,POL,Canoeing,1996,0,0,1,1
4807,POL,Archery,1996,0,0,3,3
4808,POL,Rowing,2000,2,0,0,2
4809,POL,Weightlifting,2000,0,2,0,2
4810,POL,Athletics,2000,4,0,0,4
4811,POL,Fencing,2000,0,4,0,4
4812,POL,Shooting,2000,1,0,0,1
4813,POL,Canoeing,2000,0,4,6,10
4814,POL,Gymnastics,2000,0,0,1,1
4815,POL,Sailing,2004,0,0,1,1
4816,POL,Rowing,2004,2,0,0,2
4817,POL,Weightlifting,2004,0,0,1,1
4818,POL,Athletics,2004,1,0,1,2
4819,POL,Swimming,2004,1,2,0,3
4820,POL,Fencing,2004,0,0,1,1
4821,POL,Canoeing,2004,0,0,2,2
4822,POL,Rowing,2008,4,4,0,8
4823,POL,Weightlifting,2008,0,1,0,1
4824,POL,Wrestling,2008,0,0,1,1
4825,POL,Athletics,2008,1,1,0,2
4826,POL,Fencing,2008,0,4,0,4
4827,POL,Cycling,2008,0,1,0,1
4828,POL,Canoeing,2008,0,2,0,2
4829,POL,Gymnastics,2008,1,0,0,1
4830,POL,Sailing,2012,0,0,2,2
4831,POL,Rowing,2012,0,0,2,2
4832,POL,Weightlifting,2012,1,0,1,2
4833,POL,Wrestling,2012,0,0,1,1
4834,POL,Athletics,2012,1,1,0,2
4835,POL,Shooting,2012,0,1,0,1
4836,POL,Canoeing,2012,0,0,2,2
4837,POL,Rowing,2016,2,0,4,6
4838,POL,Wrestling,2016,0,0,1,1
4839,POL,Athletics,2016,1,1,1,3
4840,POL,Cycling,2016,0,1,1,2
4841,POL,Canoeing,2016,0,1,2,3
4842,POL,Modern Pentathlon,2016,0,0,1,1
4843,POL,Sailing,2020,0,2,0,2
4844,POL,Rowing,2020,0,4,0,4
4845,POL,Wrestling,2020,0,0,1,1
4846,POL,Athletics,2020,14,6,3,23
4847,POL,Canoe Sprint,2020,0,2,4,6
4848,POL,Rowing,2024,0,0,4,4
4849,POL,Tennis,2024,0,0,1,1
4850,POL,Boxing,2024,0,1,0,1
4851,POL,Athletics,2024,0,0,1,1
4852,POL,Fencing,2024,0,0,4,4
4853,POL,Volleyball,2024,0,13,0,13
4854,POL,Canoe Slalom,2024,0,1,0,1
4855,POL,Cycling Track,2024,0,1,0,1
4856,POL,Sport Climbing,2024,1,0,1,2
4857,POR,Equestrianism,1924,0,0,4,4
4858,POR,Fencing,1928,0,0,6,6
4859,POR,Equestrianism,1936,0,0,3,3
4860,POR,Sailing,1948,0,2,0,2
4861,POR,Equestrianism,1948,0,0,3,3
4862,POR,Sailing,1952,0,0,2,2
4863,POR,Sailing,1960,0,2,0,2
4864,POR,Athletics,1976,0,1,0,1
4865,POR,Shooting,1976,0,1,0,1
4866,POR,Athletics,1984,1,0,2,3
4867,POR,Athletics,1988,1,0,0,1
4868,POR,Sailing,1996,0,0,2,2
4869,POR,Athletics,1996,1,0,0,1
4870,POR,Athletics,2000,0,0,1,1
4871,POR,Judo,2000,0,0,1,1
4872,POR,Athletics,2004,0,1,1,2
4873,POR,Cycling,2004,0,1,0,1
4874,POR,Athletics,2008,1,0,0,1
4875,POR,Triathlon,2008,0,1,0,1
4876,POR,Canoeing,2012,0,2,0,2
4877,POR,Judo,2016,0,0,1,1
4878,POR,Athletics,2020,1,1,0,2
4879,POR,Judo,2020,0,0,1,1
4880,POR,Canoe Sprint,2020,0,0,1,1
4881,POR,Athletics,2024,0,1,0,1
4882,POR,Judo,2024,0,0,1,1
4883,POR,Cycling Track,2024,2,1,0,3
4884,PRK,Wrestling,1972,0,0,1,1
4885,PRK,Boxing,1972,0,1,0,1
4886,PRK,Judo,1972,0,0,1,1
4887,PRK,Shooting,1972,1,0,0,1
4888,PRK,Volleyball,1972,0,0,11,11
4889,PRK,Boxing,1976,1,1,0,2
4890,PRK,Weightlifting,1980,0,1,1,2
4891,PRK,Wrestling,1980,0,2,0,2
4892,PRK,Boxing,1980,0,0,1,1
4893,PRK,Weightlifting,1992,0,0,1,1
4894,PRK,Wrestling,1992,2,0,1,3
4895,PRK,Boxing,1992,1,0,1,2
4896,PRK,Gymnastics,1992,1,0,0,1
4897,PRK,Table Tennis,1992,0,0,3,3
4898,PRK,Weightlifting,1996,0,1,1,2
4899,PRK,Wrestling,1996,1,0,1,2
4900,PRK,Judo,1996,1,0,0,1
4901,PRK,Weightlifting,2000,0,1,0,1
4902,PRK,Wrestling,2000,0,0,1,1
4903,PRK,Boxing,2000,0,0,1,1
4904,PRK,Judo,2000,0,0,1,1
4905,PRK,Weightlifting,2004,0,1,0,1
4906,PRK,Boxing,2004,0,1,0,1
4907,PRK,Judo,2004,0,1,0,1
4908,PRK,Shooting,2004,0,0,1,1
4909,PRK,Table Tennis,2004,0,1,0,1
4910,PRK,Weightlifting,2008,1,0,1,2
4911,PRK,Judo,2008,0,1,2,3
4912,PRK,Gymnastics,2008,1,0,0,1
4913,PRK,Weightlifting,2012,3,0,1,4
4914,PRK,Wrestling,2012,0,0,1,1
4915,PRK,Judo,2012,1,0,0,1
4916,PRK,Weightlifting,2016,1,3,0,4
4917,PRK,Shooting,2016,0,0,1,1
4918,PRK,Gymnastics,2016,1,0,0,1
4919,PRK,Table Tennis,2016,0,0,1,1
4920,PRK,Wrestling,2024,0,0,2,2
4921,PRK,Boxing,2024,0,0,1,1
4922,PRK,Diving,2024,0,2,1,3
4923,PRK,Table Tennis,2024,0,2,0,2
4924,PUR,Boxing,1948,0,0,1,1
4925,PUR,Boxing,1976,0,0,1,1
4926,PUR,Boxing,1984,0,1,1,2
4927,PUR,Boxing,1992,0,0,1,1
4928,PUR,Boxing,1996,0,0,1,1
4929,PUR,Wrestling,2012,0,1,0,1
4930,PUR,Athletics,2012,0,0,1,1
4931,PUR,Tennis,2016,1,0,0,1
4932,PUR,Athletics,2020,1,0,0,1
4933,PUR,Wrestling,2024,0,0,1,1
4934,PUR,Athletics,2024,0,0,1,1
4935,QAT,Athletics,1992,0,0,1,1
4936,QAT,Weightlifting,2000,0,0,1,1
4937,QAT,Athletics,2012,0,0,1,1
4938,QAT,Shooting,2012,0,0,1,1
4939,QAT,Athletics,2016,0,1,0,1
4940,QAT,Weightlifting,2020,1,0,0,1
4941,QAT,Athletics,2020,1,0,0,1
4942,QAT,Beach Volleyball,2020,0,0,2,2
4943,QAT,Athletics,2024,0,0,1,1
4944,ROC,Taekwondo,2020,2,1,1,4
4945,ROC,Rowing,2020,0,3,0,3
4946,ROC,Tennis,2020,2,3,0,5
4947,ROC,Wrestling,2020,4,0,4,8
4948,ROC,Boxing,2020,1,1,4,6
4949,ROC,Athletics,2020,1,1,0,2
4950,ROC,Judo,2020,0,0,3,3
4951,ROC,Artistic Gymnastics,2020,8,2,4,14
4952,ROC,Swimming,2020,2,7,1,10
4953,ROC,Fencing,2020,9,10,1,20
4954,ROC,Shooting,2020,2,5,3,10
4955,ROC,Volleyball,2020,0,12,0,12
4956,ROC,Diving,2020,0,0,2,2
4957,ROC,Beach Volleyball,2020,0,2,0,2
4958,ROC,Archery,2020,0,4,0,4
4959,ROC,Cycling Track,2020,0,0,5,5
4960,ROC,Handball,2020,0,15,0,15
4961,ROC,Rhythmic Gymnastics,2020,0,6,0,6
4962,ROC,3x3 Basketball,2020,0,8,0,8
4963,ROC,Artistic Swimming,2020,10,0,0,10
4964,ROU,Rugby,1924,0,0,16,16
4965,ROU,Equestrianism,1936,0,1,0,1
4966,ROU,Boxing,1952,0,1,1,2
4967,ROU,Shooting,1952,1,0,1,2
4968,ROU,Wrestling,1956,0,0,1,1
4969,ROU,Boxing,1956,1,2,1,4
4970,ROU,Fencing,1956,0,1,0,1
4971,ROU,Shooting,1956,1,0,1,2
4972,ROU,Canoeing,1956,4,0,0,4
4973,ROU,Gymnastics,1956,0,0,7,7
4974,ROU,Wrestling,1960,1,1,1,3
4975,ROU,Boxing,1960,0,0,1,1
4976,ROU,Athletics,1960,1,0,1,2
4977,ROU,Fencing,1960,0,0,1,1
4978,ROU,Shooting,1960,1,0,0,1
4979,ROU,Canoeing,1960,0,0,1,1
4980,ROU,Gymnastics,1960,0,0,6,6
4981,ROU,Wrestling,1964,0,1,2,3
4982,ROU,Athletics,1964,2,0,1,3
4983,ROU,Shooting,1964,0,1,0,1
4984,ROU,Canoeing,1964,0,2,7,9
4985,ROU,Wrestling,1968,0,1,2,3
4986,ROU,Boxing,1968,0,1,1,2
4987,ROU,Athletics,1968,2,2,0,4
4988,ROU,Fencing,1968,1,0,5,6
4989,ROU,Shooting,1968,0,1,0,1
4990,ROU,Canoeing,1968,2,4,1,7
4991,ROU,Rowing,1972,0,0,3,3
4992,ROU,Wrestling,1972,2,0,2,4
4993,ROU,Boxing,1972,0,1,0,1
4994,ROU,Athletics,1972,0,2,0,2
4995,ROU,Fencing,1972,0,0,4,4
4996,ROU,Shooting,1972,0,1,1,2
4997,ROU,Canoeing,1972,1,6,2,9
4998,ROU,Handball,1972,0,0,15,15
4999,ROU,Rowing,1976,0,0,5,5
5000,ROU,Wrestling,1976,0,3,3,6
5001,ROU,Boxing,1976,0,2,3,5
5002,ROU,Athletics,1976,0,0,1,1
5003,ROU,Fencing,1976,0,0,5,5
5004,ROU,Canoeing,1976,1,2,3,6
5005,ROU,Gymnastics,1976,3,7,3,13
5006,ROU,Handball,1976,0,14,0,14
5007,ROU,Rowing,1980,1,0,11,12
5008,ROU,Wrestling,1980,1,1,2,4
5009,ROU,Boxing,1980,0,0,2,2
5010,ROU,Shooting,1980,1,0,0,1
5011,ROU,Equestrianism,1980,0,0,3,3
5012,ROU,Volleyball,1980,0,0,10,10
5013,ROU,Canoeing,1980,2,6,2,10
5014,ROU,Gymnastics,1980,2,8,2,12
5015,ROU,Handball,1980,0,0,14,14
5016,ROU,Rowing,1984,17,12,0,29
5017,ROU,Weightlifting,1984,2,5,1,8
5018,ROU,Wrestling,1984,2,1,3,6
5019,ROU,Boxing,1984,0,0,1,1
5020,ROU,Athletics,1984,3,3,4,10
5021,ROU,Judo,1984,0,0,2,2
5022,ROU,Swimming,1984,0,0,1,1
5023,ROU,Fencing,1984,0,5,5,10
5024,ROU,Shooting,1984,0,1,0,1
5025,ROU,Canoeing,1984,6,2,1,9
5026,ROU,Gymnastics,1984,10,1,2,13
5027,ROU,Handball,1984,0,0,15,15
5028,ROU,Rhythmic Gymnastics,1984,0,1,0,1
5029,ROU,Rowing,1988,2,22,12,36
5030,ROU,Weightlifting,1988,0,1,0,1
5031,ROU,Wrestling,1988,1,0,0,1
5032,ROU,Boxing,1988,0,1,0,1
5033,ROU,Athletics,1988,1,1,0,2
5034,ROU,Swimming,1988,0,1,1,2
5035,ROU,Shooting,1988,1,0,0,1
5036,ROU,Gymnastics,1988,3,8,3,14
5037,ROU,Rowing,1992,6,24,3,33
5038,ROU,Weightlifting,1992,0,0,1,1
5039,ROU,Wrestling,1992,0,0,1,1
5040,ROU,Boxing,1992,0,0,1,1
5041,ROU,Athletics,1992,0,1,0,1
5042,ROU,Fencing,1992,0,0,5,5
5043,ROU,Shooting,1992,0,0,1,1
5044,ROU,Gymnastics,1992,2,6,2,10
5045,ROU,Rowing,1996,11,0,0,11
5046,ROU,Weightlifting,1996,0,0,1,1
5047,ROU,Boxing,1996,0,0,2,2
5048,ROU,Athletics,1996,0,1,0,1
5049,ROU,Fencing,1996,1,3,0,4
5050,ROU,Canoeing,1996,0,2,2,4
5051,ROU,Gymnastics,1996,1,4,10,15
5052,ROU,Rowing,2000,13,0,0,13
5053,ROU,Boxing,2000,0,1,1,2
5054,ROU,Athletics,2000,1,2,2,5
5055,ROU,Judo,2000,0,0,1,1
5056,ROU,Swimming,2000,2,1,1,4
5057,ROU,Fencing,2000,1,0,0,1
5058,ROU,Shooting,2000,0,0,1,1
5059,ROU,Canoeing,2000,2,0,6,8
5060,ROU,Gymnastics,2000,8,2,1,11
5061,ROU,Rowing,2004,13,0,0,13
5062,ROU,Boxing,2004,0,0,1,1
5063,ROU,Athletics,2004,0,2,1,3
5064,ROU,Swimming,2004,1,0,1,2
5065,ROU,Gymnastics,2004,9,3,8,20
5066,ROU,Rowing,2008,2,0,9,11
5067,ROU,Athletics,2008,1,0,0,1
5068,ROU,Judo,2008,1,0,0,1
5069,ROU,Fencing,2008,0,1,1,2
5070,ROU,Gymnastics,2008,1,0,6,7
5071,ROU,Weightlifting,2012,0,1,1,2
5072,ROU,Judo,2012,0,2,0,2
5073,ROU,Fencing,2012,0,4,0,4
5074,ROU,Shooting,2012,1,0,0,1
5075,ROU,Gymnastics,2012,1,1,5,7
5076,ROU,Rowing,2016,0,0,9,9
5077,ROU,Tennis,2016,0,2,0,2
5078,ROU,Wrestling,2016,0,0,1,1
5079,ROU,Fencing,2016,4,0,0,4
5080,ROU,Rowing,2020,2,6,0,8
5081,ROU,Fencing,2020,0,1,0,1
5082,ROU,Rowing,2024,11,6,0,17
5083,ROU,Weightlifting,2024,0,1,0,1
5084,ROU,Artistic Gymnastics,2024,0,0,1,1
5085,ROU,Swimming,2024,1,0,1,2
5086,RSA,Athletics,1908,1,1,0,2
5087,RSA,Tennis,1912,3,1,0,4
5088,RSA,Athletics,1912,1,1,0,2
5089,RSA,Cycling,1912,1,0,0,1
5090,RSA,Tennis,1920,1,0,1,2
5091,RSA,Boxing,1920,1,0,0,1
5092,RSA,Athletics,1920,1,4,1,6
5093,RSA,Shooting,1920,0,5,0,5
5094,RSA,Cycling,1920,0,3,4,7
5095,RSA,Boxing,1924,1,0,0,1
5096,RSA,Athletics,1924,0,1,1,2
5097,RSA,Boxing,1928,0,0,1,1
5098,RSA,Athletics,1928,1,0,0,1
5099,RSA,Swimming,1928,0,0,4,4
5100,RSA,Boxing,1932,2,0,1,3
5101,RSA,Athletics,1932,0,0,1,1
5102,RSA,Swimming,1932,0,0,1,1
5103,RSA,Boxing,1936,0,1,0,1
5104,RSA,Boxing,1948,2,1,1,4
5105,RSA,Art Competitions,1948,0,1,1,2
5106,RSA,Boxing,1952,0,1,3,4
5107,RSA,Athletics,1952,1,1,0,2
5108,RSA,Swimming,1952,1,0,0,1
5109,RSA,Cycling,1952,0,6,1,7
5110,RSA,Boxing,1956,0,0,2,2
5111,RSA,Swimming,1956,0,0,4,4
5112,RSA,Cycling,1956,0,0,1,1
5113,RSA,Boxing,1960,0,1,1,2
5114,RSA,Athletics,1960,0,0,1,1
5115,RSA,Tennis,1992,0,2,0,2
5116,RSA,Athletics,1992,0,1,0,1
5117,RSA,Athletics,1996,1,1,0,2
5118,RSA,Swimming,1996,2,0,1,3
5119,RSA,Athletics,2000,0,1,2,3
5120,RSA,Swimming,2000,0,1,1,2
5121,RSA,Rowing,2004,0,0,2,2
5122,RSA,Athletics,2004,0,2,0,2
5123,RSA,Swimming,2004,4,1,1,6
5124,RSA,Athletics,2008,0,1,0,1
5125,RSA,Rowing,2012,4,0,0,4
5126,RSA,Athletics,2012,0,1,0,1
5127,RSA,Swimming,2012,2,1,0,3
5128,RSA,Canoeing,2012,0,0,1,1
5129,RSA,Rowing,2016,0,2,0,2
5130,RSA,Athletics,2016,2,2,0,4
5131,RSA,Swimming,2016,0,3,0,3
5132,RSA,Rugby Sevens,2016,0,0,13,13
5133,RSA,Triathlon,2016,0,0,1,1
5134,RSA,Swimming,2020,1,1,0,2
5135,RSA,Surfing,2020,0,1,0,1
5136,RSA,Athletics,2024,0,5,0,5
5137,RSA,Swimming,2024,1,1,0,2
5138,RSA,Rugby Sevens,2024,0,0,13,13
5139,RSA,Cycling Mountain Bike,2024,0,0,1,1
5140,RUS,Wrestling,1908,0,2,0,2
5141,RUS,Figure Skating,1908,1,0,0,1
5142,RUS,Sailing,1912,0,0,7,7
5143,RUS,Rowing,1912,0,0,1,1
5144,RUS,Wrestling,1912,0,1,0,1
5145,RUS,Shooting,1912,0,4,1,5
5146,RUS,Sailing,1996,0,3,0,3
5147,RUS,Rowing,1996,0,0,9,9
5148,RUS,Weightlifting,1996,2,1,0,3
5149,RUS,Wrestling,1996,4,1,2,7
5150,RUS,Boxing,1996,1,0,3,4
5151,RUS,Athletics,1996,3,6,1,10
5152,RUS,Swimming,1996,4,13,2,19
5153,RUS,Fencing,1996,8,4,3,15
5154,RUS,Shooting,1996,3,2,1,6
5155,RUS,Cycling,1996,1,4,0,5
5156,RUS,Diving,1996,1,1,0,2
5157,RUS,Canoeing,1996,0,0,4,4
5158,RUS,Modern Pentathlon,1996,0,1,0,1
5159,RUS,Gymnastics,1996,9,8,3,20
5160,RUS,Rhythmic Gymnastics,1996,0,1,6,7
5161,RUS,Taekwondo,2000,0,1,0,1
5162,RUS,Rowing,2000,0,0,4,4
5163,RUS,Tennis,2000,1,1,0,2
5164,RUS,Weightlifting,2000,0,1,2,3
5165,RUS,Wrestling,2000,6,2,1,9
5166,RUS,Boxing,2000,2,3,2,7
5167,RUS,Athletics,2000,3,4,11,18
5168,RUS,Judo,2000,0,1,2,3
5169,RUS,Swimming,2000,0,1,1,2
5170,RUS,Fencing,2000,8,0,1,9
5171,RUS,Shooting,2000,1,3,2,6
5172,RUS,Volleyball,2000,0,24,0,24
5173,RUS,Cycling,2000,1,1,2,4
5174,RUS,Diving,2000,4,2,2,8
5175,RUS,Canoeing,2000,0,1,0,1
5176,RUS,Trampolining,2000,2,0,0,2
5177,RUS,Water Polo,2000,0,12,13,25
5178,RUS,Modern Pentathlon,2000,1,0,0,1
5179,RUS,Gymnastics,2000,5,10,10,25
5180,RUS,Handball,2000,15,0,0,15
5181,RUS,Rhythmic Gymnastics,2000,7,0,1,8
5182,RUS,Synchronized Swimming,2000,10,0,0,10
5183,RUS,Rowing,2004,4,0,0,4
5184,RUS,Weightlifting,2004,1,2,4,7
5185,RUS,Wrestling,2004,5,2,3,10
5186,RUS,Boxing,2004,3,0,3,6
5187,RUS,Athletics,2004,6,15,6,27
5188,RUS,Judo,2004,0,2,3,5
5189,RUS,Swimming,2004,0,1,0,1
5190,RUS,Fencing,2004,4,0,9,13
5191,RUS,Shooting,2004,3,4,3,10
5192,RUS,Volleyball,2004,0,10,12,22
5193,RUS,Basketball,2004,0,0,12,12
5194,RUS,Cycling,2004,3,1,1,5
5195,RUS,Diving,2004,0,4,2,6
5196,RUS,Canoeing,2004,0,2,3,5
5197,RUS,Trampolining,2004,0,1,0,1
5198,RUS,Water Polo,2004,0,0,13,13
5199,RUS,Modern Pentathlon,2004,1,0,0,1
5200,RUS,Gymnastics,2004,0,1,7,8
5201,RUS,Handball,2004,0,0,14,14
5202,RUS,Rhythmic Gymnastics,2004,7,1,0,8
5203,RUS,Synchronized Swimming,2004,11,0,0,11
5204,RUS,Tennis,2008,1,1,1,3
5205,RUS,Weightlifting,2008,0,4,3,7
5206,RUS,Wrestling,2008,6,3,2,11
5207,RUS,Boxing,2008,2,0,1,3
5208,RUS,Athletics,2008,9,10,6,25
5209,RUS,Swimming,2008,1,5,2,8
5210,RUS,Fencing,2008,4,0,0,4
5211,RUS,Shooting,2008,0,2,2,4
5212,RUS,Volleyball,2008,0,0,12,12
5213,RUS,Basketball,2008,0,0,12,12
5214,RUS,Cycling,2008,0,0,4,4
5215,RUS,Diving,2008,0,5,3,8
5216,RUS,Canoeing,2008,1,2,2,5
5217,RUS,Archery,2008,0,0,1,1
5218,RUS,Modern Pentathlon,2008,1,0,0,1
5219,RUS,Gymnastics,2008,0,0,2,2
5220,RUS,Handball,2008,0,14,0,14
5221,RUS,Rhythmic Gymnastics,2008,7,0,0,7
5222,RUS,Synchronized Swimming,2008,11,0,0,11
5223,RUS,Taekwondo,2012,0,0,2,2
5224,RUS,Tennis,2012,0,1,2,3
5225,RUS,Weightlifting,2012,0,5,1,6
5226,RUS,Wrestling,2012,4,2,5,11
5227,RUS,Boxing,2012,1,2,3,6
5228,RUS,Athletics,2012,8,10,5,23
5229,RUS,Judo,2012,3,1,1,5
5230,RUS,Swimming,2012,0,2,7,9
5231,RUS,Fencing,2012,0,5,1,6
5232,RUS,Shooting,2012,0,0,1,1
5233,RUS,Volleyball,2012,12,0,0,12
5234,RUS,Basketball,2012,0,0,12,12
5235,RUS,Cycling,2012,0,0,2,2
5236,RUS,Diving,2012,1,2,0,3
5237,RUS,Canoeing,2012,2,0,3,5
5238,RUS,Trampolining,2012,0,1,0,1
5239,RUS,Gymnastics,2012,1,7,4,12
5240,RUS,Rhythmic Gymnastics,2012,7,1,0,8
5241,RUS,Synchronized Swimming,2012,11,0,0,11
5242,RUS,Badminton,2012,0,0,2,2
5243,RUS,Taekwondo,2016,0,1,0,1
5244,RUS,Sailing,2016,0,0,1,1
5245,RUS,Tennis,2016,2,0,0,2
5246,RUS,Wrestling,2016,4,3,2,9
5247,RUS,Boxing,2016,1,0,3,4
5248,RUS,Judo,2016,2,0,1,3
5249,RUS,Swimming,2016,0,2,2,4
5250,RUS,Fencing,2016,9,1,5,15
5251,RUS,Shooting,2016,0,2,2,4
5252,RUS,Cycling,2016,0,3,1,4
5253,RUS,Canoeing,2016,0,0,2,2
5254,RUS,Archery,2016,0,3,0,3
5255,RUS,Water Polo,2016,0,0,13,13
5256,RUS,Modern Pentathlon,2016,1,0,0,1
5257,RUS,Gymnastics,2016,1,12,3,16
5258,RUS,Handball,2016,15,0,0,15
5259,RUS,Rhythmic Gymnastics,2016,6,1,0,7
5260,RUS,Synchronized Swimming,2016,11,0,0,11
5261,SCG,Shooting,1996,1,0,1,2
5262,SCG,Volleyball,1996,0,0,12,12
5263,SCG,Basketball,1996,0,12,0,12
5264,SCG,Shooting,2000,0,1,0,1
5265,SCG,Volleyball,2000,11,0,0,11
5266,SCG,Water Polo,2000,0,0,13,13
5267,SCG,Shooting,2004,0,1,0,1
5268,SCG,Water Polo,2004,0,12,0,12
5269,SEN,Athletics,1988,0,1,0,1
5270,SGP,Weightlifting,1960,0,1,0,1
5271,SGP,Table Tennis,2008,0,3,0,3
5272,SGP,Table Tennis,2012,0,0,4,4
5273,SGP,Swimming,2016,1,0,0,1
5274,SGP,Sailing,2024,0,0,1,1
5275,SLO,Rowing,1992,0,0,6,6
5276,SLO,Athletics,1996,0,1,0,1
5277,SLO,Canoeing,1996,0,1,0,1
5278,SLO,Rowing,2000,2,0,0,2
5279,SLO,Shooting,2000,1,0,0,1
5280,SLO,Sailing,2004,0,0,1,1
5281,SLO,Rowing,2004,0,2,0,2
5282,SLO,Athletics,2004,0,0,1,1
5283,SLO,Judo,2004,0,0,1,1
5284,SLO,Sailing,2008,0,1,0,1
5285,SLO,Athletics,2008,1,0,0,1
5286,SLO,Judo,2008,0,0,1,1
5287,SLO,Swimming,2008,0,1,0,1
5288,SLO,Shooting,2008,0,0,1,1
5289,SLO,Rowing,2012,0,0,2,2
5290,SLO,Athletics,2012,0,1,0,1
5291,SLO,Judo,2012,1,0,0,1
5292,SLO,Shooting,2012,0,0,1,1
5293,SLO,Sailing,2016,0,1,0,1
5294,SLO,Judo,2016,1,0,1,2
5295,SLO,Canoeing,2016,0,1,0,1
5296,SLO,Judo,2020,0,1,0,1
5297,SLO,Canoe Slalom,2020,1,0,0,1
5298,SLO,Cycling Road,2020,1,0,1,2
5299,SLO,Sport Climbing,2020,1,0,0,1
5300,SLO,Sailing,2024,0,1,0,1
5301,SLO,Judo,2024,1,0,0,1
5302,SLO,Sport Climbing,2024,1,0,0,1
5303,SMR,Wrestling,2020,0,0,1,1
5304,SMR,Shooting,2020,0,2,1,3
5305,SRB,Tennis,2008,0,0,1,1
5306,SRB,Swimming,2008,0,1,0,1
5307,SRB,Water Polo,2008,0,0,13,13
5308,SRB,Taekwondo,2012,1,0,0,1
5309,SRB,Shooting,2012,0,1,1,2
5310,SRB,Water Polo,2012,0,0,13,13
5311,SRB,Taekwondo,2016,0,1,0,1
5312,SRB,Wrestling,2016,1,0,0,1
5313,SRB,Athletics,2016,0,0,1,1
5314,SRB,Volleyball,2016,0,12,0,12
5315,SRB,Basketball,2016,0,12,12,24
5316,SRB,Canoeing,2016,0,2,0,2
5317,SRB,Water Polo,2016,13,0,0,13
5318,SRB,Taekwondo,2020,1,0,1,2
5319,SRB,Wrestling,2020,0,0,1,1
5320,SRB,Shooting,2020,0,1,1,2
5321,SRB,Volleyball,2020,0,0,12,12
5322,SRB,Water Polo,2020,13,0,0,13
5323,SRB,Karate,2020,1,0,0,1
5324,SRB,3x3 Basketball,2020,0,0,4,4
5325,SRB,Taekwondo,2024,0,1,0,1
5326,SRB,Tennis,2024,1,0,0,1
5327,SRB,Shooting,2024,2,0,0,2
5328,SRB,Basketball,2024,0,0,12,12
5329,SRB,Water Polo,2024,13,0,0,13
5330,SRI,Athletics,1948,0,1,0,1
5331,SRI,Athletics,2000,0,1,0,1
5332,SUD,Athletics,2008,0,1,0,1
5333,SUI,Gymnastics,1896,1,2,0,3
5334,SUI,Sailing,1900,3,3,0,6
5335,SUI,Shooting,1900,13,1,1,15
5336,SUI,Wrestling,1904,0,0,1,1
5337,SUI,Gymnastics,1904,1,0,1,2
5338,SUI,Shooting,1906,8,3,1,12
5339,SUI,Art Competitions,1912,2,0,0,2
5340,SUI,Rowing,1920,5,0,3,8
5341,SUI,Weightlifting,1920,0,1,1,2
5342,SUI,Wrestling,1920,1,1,0,2
5343,SUI,Shooting,1920,0,0,17,17
5344,SUI,Rowing,1924,9,0,7,16
5345,SUI,Weightlifting,1924,0,1,1,2
5346,SUI,Wrestling,1924,2,1,2,5
5347,SUI,Athletics,1924,0,2,0,2
5348,SUI,Football,1924,0,15,0,15
5349,SUI,Shooting,1924,0,0,1,1
5350,SUI,Equestrianism,1924,1,4,0,5
5351,SUI,Gymnastics,1924,2,2,10,14
5352,SUI,Rowing,1928,3,5,0,8
5353,SUI,Wrestling,1928,1,1,1,3
5354,SUI,Equestrianism,1928,0,0,1,1
5355,SUI,Gymnastics,1928,12,2,2,16
5356,SUI,Art Competitions,1928,0,2,0,2
5357,SUI,Gymnastics,1932,0,1,0,1
5358,SUI,Rowing,1936,0,5,4,9
5359,SUI,Athletics,1936,0,1,0,1
5360,SUI,Cycling,1936,0,4,1,5
5361,SUI,Gymnastics,1936,1,13,2,16
5362,SUI,Art Competitions,1936,1,0,0,1
5363,SUI,Handball,1936,0,0,17,17
5364,SUI,Alpinism,1936,2,0,0,2
5365,SUI,Aeronautics,1936,1,0,0,1
5366,SUI,Rowing,1948,0,7,0,7
5367,SUI,Wrestling,1948,0,1,2,3
5368,SUI,Athletics,1948,0,1,1,2
5369,SUI,Fencing,1948,0,1,0,1
5370,SUI,Shooting,1948,1,1,0,2
5371,SUI,Equestrianism,1948,1,0,0,1
5372,SUI,Gymnastics,1948,3,11,2,16
5373,SUI,Art Competitions,1948,0,3,1,4
5374,SUI,Rowing,1952,0,5,2,7
5375,SUI,Athletics,1952,0,1,0,1
5376,SUI,Fencing,1952,0,0,7,7
5377,SUI,Shooting,1952,0,1,0,1
5378,SUI,Equestrianism,1952,0,3,0,3
5379,SUI,Gymnastics,1952,2,9,3,14
5380,SUI,Equestrianism,1956,0,0,3,3
5381,SUI,Sailing,1960,0,0,3,3
5382,SUI,Rowing,1960,0,0,2,2
5383,SUI,Shooting,1960,0,1,0,1
5384,SUI,Equestrianism,1960,0,5,1,6
5385,SUI,Rowing,1964,0,0,1,1
5386,SUI,Judo,1964,0,1,0,1
5387,SUI,Equestrianism,1964,1,3,0,4
5388,SUI,Sailing,1968,0,3,0,3
5389,SUI,Rowing,1968,0,0,5,5
5390,SUI,Shooting,1968,0,0,1,1
5391,SUI,Equestrianism,1968,0,0,3,3
5392,SUI,Cycling,1968,0,0,1,1
5393,SUI,Rowing,1972,0,2,0,2
5394,SUI,Fencing,1972,0,5,0,5
5395,SUI,Cycling,1972,0,1,0,1
5396,SUI,Judo,1976,0,0,1,1
5397,SUI,Fencing,1976,0,0,5,5
5398,SUI,Equestrianism,1976,1,3,0,4
5399,SUI,Judo,1980,1,0,0,1
5400,SUI,Cycling,1980,1,0,0,1
5401,SUI,Wrestling,1984,0,0,1,1
5402,SUI,Athletics,1984,0,1,0,1
5403,SUI,Swimming,1984,0,0,1,1
5404,SUI,Shooting,1984,0,1,0,1
5405,SUI,Equestrianism,1984,0,3,2,5
5406,SUI,Cycling,1984,0,4,0,4
5407,SUI,Rowing,1988,0,2,0,2
5408,SUI,Athletics,1988,0,0,1,1
5409,SUI,Equestrianism,1988,0,4,1,5
5410,SUI,Tennis,1992,1,0,0,1
5411,SUI,Rowing,1996,3,0,0,3
5412,SUI,Equestrianism,1996,0,1,0,1
5413,SUI,Cycling,1996,1,1,0,2
5414,SUI,Canoeing,1996,0,4,0,4
5415,SUI,Gymnastics,1996,1,0,0,1
5416,SUI,Rowing,2000,0,1,0,1
5417,SUI,Fencing,2000,0,4,0,4
5418,SUI,Shooting,2000,0,1,0,1
5419,SUI,Equestrianism,2000,0,4,0,4
5420,SUI,Cycling,2000,0,1,1,2
5421,SUI,Triathlon,2000,1,0,1,2
5422,SUI,Fencing,2004,1,0,0,1
5423,SUI,Cycling,2004,0,2,1,3
5424,SUI,Beach Volleyball,2004,0,0,2,2
5425,SUI,Triathlon,2004,0,0,1,1
5426,SUI,Tennis,2008,2,0,0,2
5427,SUI,Judo,2008,0,0,1,1
5428,SUI,Equestrianism,2008,0,0,4,4
5429,SUI,Cycling,2008,1,1,2,4
5430,SUI,Tennis,2012,0,1,0,1
5431,SUI,Equestrianism,2012,1,0,0,1
5432,SUI,Cycling,2012,0,1,0,1
5433,SUI,Triathlon,2012,1,0,0,1
5434,SUI,Rowing,2016,4,0,0,4
5435,SUI,Tennis,2016,0,2,0,2
5436,SUI,Shooting,2016,0,0,1,1
5437,SUI,Cycling,2016,2,0,0,2
5438,SUI,Triathlon,2016,0,1,0,1
5439,SUI,Gymnastics,2016,0,0,1,1
5440,SUI,Tennis,2020,1,2,0,3
5441,SUI,Swimming,2020,0,0,2,2
5442,SUI,Shooting,2020,1,0,1,2
5443,SUI,Cycling BMX Freestyle,2020,0,0,1,1
5444,SUI,Beach Volleyball,2020,0,0,2,2
5445,SUI,Cycling Road,2020,0,1,0,1
5446,SUI,Cycling Mountain Bike,2020,1,2,1,4
5447,SUI,Rowing,2024,0,0,2,2
5448,SUI,Swimming,2024,0,0,1,1
5449,SUI,Shooting,2024,1,0,1,2
5450,SUI,Beach Volleyball,2024,0,0,2,2
5451,SUI,Triathlon,2024,0,1,0,1
5452,SUI,Equestrian,2024,0,1,0,1
5453,SUI,Cycling BMX Racing,2024,0,0,1,1
5454,SUR,Swimming,1988,1,0,0,1
5455,SUR,Swimming,1992,0,0,1,1
5456,SVK,Shooting,1996,0,0,1,1
5457,SVK,Canoeing,1996,1,1,0,2
5458,SVK,Swimming,2000,0,2,0,2
5459,SVK,Canoeing,2000,2,1,1,4
5460,SVK,Judo,2004,0,1,0,1
5461,SVK,Shooting,2004,0,0,1,1
5462,SVK,Canoeing,2004,3,1,4,8
5463,SVK,Wrestling,2008,0,0,1,1
5464,SVK,Shooting,2008,0,1,0,1
5465,SVK,Canoeing,2008,4,4,0,8
5466,SVK,Shooting,2012,0,1,1,2
5467,SVK,Canoeing,2012,0,0,3,3
5468,SVK,Athletics,2016,1,0,0,1
5469,SVK,Canoeing,2016,2,5,0,7
5470,SVK,Shooting,2020,1,0,0,1
5471,SVK,Canoe Slalom,2020,0,1,0,1
5472,SVK,Canoe Sprint,2020,0,0,4,4
5473,SVK,Golf,2020,0,1,0,1
5474,SVK,Canoe Slalom,2024,0,0,1,1
5475,SWE,Athletics,1900,0,0,1,1
5476,SWE,Tug-Of-War,1900,3,0,0,3
5477,SWE,Athletics,1906,2,4,5,11
5478,SWE,Shooting,1906,0,1,1,2
5479,SWE,Tug-Of-War,1906,0,0,8,8
5480,SWE,Sailing,1908,0,5,0,5
5481,SWE,Tennis,1908,0,0,3,3
5482,SWE,Wrestling,1908,1,1,0,2
5483,SWE,Athletics,1908,2,0,3,5
5484,SWE,Swimming,1908,0,0,2,2
5485,SWE,Shooting,1908,5,10,1,16
5486,SWE,Diving,1908,1,1,1,3
5487,SWE,Water Polo,1908,0,0,7,7
5488,SWE,Gymnastics,1908,38,0,0,38
5489,SWE,Figure Skating,1908,1,1,1,3
5490,SWE,Sailing,1912,8,15,3,26
5491,SWE,Rowing,1912,0,5,0,5
5492,SWE,Tennis,1912,0,4,2,6
5493,SWE,Wrestling,1912,1,2,1,4
5494,SWE,Athletics,1912,15,12,6,33
5495,SWE,Swimming,1912,0,1,0,1
5496,SWE,Shooting,1912,21,12,9,42
5497,SWE,Equestrianism,1912,10,1,1,12
5498,SWE,Cycling,1912,12,0,0,12
5499,SWE,Diving,1912,3,2,2,7
5500,SWE,Water Polo,1912,0,7,0,7
5501,SWE,Modern Pentathlon,1912,1,1,1,3
5502,SWE,Gymnastics,1912,24,0,0,24
5503,SWE,Tug-Of-War,1912,8,0,0,8
5504,SWE,Sailing,1920,7,4,0,11
5505,SWE,Weightlifting,1920,0,0,2,2
5506,SWE,Wrestling,1920,3,1,2,6
5507,SWE,Athletics,1920,1,3,22,26
5508,SWE,Swimming,1920,2,2,4,8
5509,SWE,Shooting,1920,1,18,16,35
5510,SWE,Equestrianism,1920,9,2,5,16
5511,SWE,Cycling,1920,1,4,0,5
5512,SWE,Diving,1920,1,2,2,5
5513,SWE,Water Polo,1920,0,0,10,10
5514,SWE,Modern Pentathlon,1920,1,1,1,3
5515,SWE,Gymnastics,1920,24,0,0,24
5516,SWE,Figure Skating,1920,2,1,0,3
5517,SWE,Wrestling,1924,1,2,1,4
5518,SWE,Athletics,1924,0,6,2,8
5519,SWE,Swimming,1924,0,2,10,12
5520,SWE,Fencing,1924,0,0,1,1
5521,SWE,Football,1924,0,0,18,18
5522,SWE,Shooting,1924,0,5,5,10
5523,SWE,Equestrianism,1924,5,5,0,10
5524,SWE,Cycling,1924,0,0,4,4
5525,SWE,Diving,1924,0,1,1,2
5526,SWE,Modern Pentathlon,1924,1,1,1,3
5527,SWE,Sailing,1928,1,0,6,7
5528,SWE,Wrestling,1928,3,1,0,4
5529,SWE,Boxing,1928,0,1,1,2
5530,SWE,Athletics,1928,1,2,4,7
5531,SWE,Swimming,1928,1,0,1,2
5532,SWE,Equestrianism,1928,0,3,4,7
5533,SWE,Cycling,1928,0,0,5,5
5534,SWE,Diving,1928,0,0,1,1
5535,SWE,Modern Pentathlon,1928,1,1,0,2
5536,SWE,Sailing,1932,4,0,2,6
5537,SWE,Wrestling,1932,6,1,3,10
5538,SWE,Boxing,1932,0,1,1,2
5539,SWE,Athletics,1932,0,1,0,1
5540,SWE,Shooting,1932,1,0,0,1
5541,SWE,Equestrianism,1932,0,3,2,5
5542,SWE,Cycling,1932,0,0,4,4
5543,SWE,Modern Pentathlon,1932,1,1,0,2
5544,SWE,Art Competitions,1932,1,0,0,1
5545,SWE,Sailing,1936,0,2,5,7
5546,SWE,Wrestling,1936,4,3,2,9
5547,SWE,Boxing,1936,0,0,1,1
5548,SWE,Athletics,1936,0,0,2,2
5549,SWE,Fencing,1936,0,6,0,6
5550,SWE,Shooting,1936,1,0,1,2
5551,SWE,Equestrianism,1936,0,0,3,3
5552,SWE,Canoeing,1936,2,0,2,4
5553,SWE,Art Competitions,1936,0,0,1,1
5554,SWE,Sailing,1948,0,3,5,8
5555,SWE,Weightlifting,1948,0,0,1,1
5556,SWE,Wrestling,1948,5,5,3,13
5557,SWE,Boxing,1948,0,1,0,1
5558,SWE,Athletics,1948,5,3,8,16
5559,SWE,Fencing,1948,0,0,6,6
5560,SWE,Football,1948,12,0,0,12
5561,SWE,Shooting,1948,0,0,3,3
5562,SWE,Equestrianism,1948,0,3,2,5
5563,SWE,Canoeing,1948,6,0,0,6
5564,SWE,Modern Pentathlon,1948,1,0,1,2
5565,SWE,Art Competitions,1948,1,0,1,2
5566,SWE,Sailing,1952,0,3,4,7
5567,SWE,Wrestling,1952,3,4,1,8
5568,SWE,Boxing,1952,0,1,1,2
5569,SWE,Athletics,1952,1,0,2,3
5570,SWE,Swimming,1952,0,0,2,2
5571,SWE,Fencing,1952,0,6,0,6
5572,SWE,Football,1952,0,0,12,12
5573,SWE,Shooting,1952,0,2,1,3
5574,SWE,Equestrianism,1952,8,0,0,8
5575,SWE,Canoeing,1952,1,5,0,6
5576,SWE,Modern Pentathlon,1952,1,3,0,4
5577,SWE,Gymnastics,1952,9,0,0,9
5578,SWE,Sailing,1956,6,0,0,6
5579,SWE,Rowing,1956,0,5,0,5
5580,SWE,Wrestling,1956,0,1,3,4
5581,SWE,Athletics,1956,0,0,1,1
5582,SWE,Shooting,1956,0,1,1,2
5583,SWE,Equestrianism,1956,5,0,0,5
5584,SWE,Canoeing,1956,2,0,0,2
5585,SWE,Modern Pentathlon,1956,1,0,0,1
5586,SWE,Gymnastics,1956,0,7,1,8
5587,SWE,Wrestling,1960,0,0,2,2
5588,SWE,Athletics,1960,0,1,0,1
5589,SWE,Swimming,1960,0,1,0,1
5590,SWE,Canoeing,1960,2,0,1,3
5591,SWE,Sailing,1964,0,3,2,5
5592,SWE,Wrestling,1964,0,1,1,2
5593,SWE,Athletics,1964,0,0,1,1
5594,SWE,Cycling,1964,0,0,4,4
5595,SWE,Canoeing,1964,3,0,0,3
5596,SWE,Sailing,1968,3,0,0,3
5597,SWE,Cycling,1968,0,4,1,5
5598,SWE,Modern Pentathlon,1968,1,0,0,1
5599,SWE,Sailing,1972,0,6,0,6
5600,SWE,Weightlifting,1972,0,0,1,1
5601,SWE,Wrestling,1972,0,1,1,2
5602,SWE,Boxing,1972,0,0,1,1
5603,SWE,Athletics,1972,0,0,1,1
5604,SWE,Swimming,1972,2,0,0,2
5605,SWE,Shooting,1972,1,0,0,1
5606,SWE,Equestrianism,1972,0,0,4,4
5607,SWE,Diving,1972,1,1,0,2
5608,SWE,Canoeing,1972,0,1,0,1
5609,SWE,Archery,1972,0,1,0,1
5610,SWE,Sailing,1976,2,0,0,2
5611,SWE,Athletics,1976,1,0,0,1
5612,SWE,Fencing,1976,5,0,0,5
5613,SWE,Cycling,1976,1,0,0,1
5614,SWE,Diving,1976,0,1,0,1
5615,SWE,Sailing,1980,0,0,2,2
5616,SWE,Wrestling,1980,0,0,2,2
5617,SWE,Swimming,1980,2,7,1,10
5618,SWE,Fencing,1980,1,0,0,1
5619,SWE,Shooting,1980,0,1,1,2
5620,SWE,Modern Pentathlon,1980,0,0,3,3
5621,SWE,Wrestling,1984,0,2,2,4
5622,SWE,Athletics,1984,0,2,1,3
5623,SWE,Swimming,1984,0,0,7,7
5624,SWE,Fencing,1984,0,1,0,1
5625,SWE,Shooting,1984,0,1,0,1
5626,SWE,Equestrianism,1984,0,0,3,3
5627,SWE,Canoeing,1984,3,11,0,14
5628,SWE,Modern Pentathlon,1984,0,1,0,1
5629,SWE,Sailing,1988,0,2,0,2
5630,SWE,Tennis,1988,0,0,3,3
5631,SWE,Wrestling,1988,0,0,1,1
5632,SWE,Boxing,1988,0,1,1,2
5633,SWE,Athletics,1988,0,0,1,1
5634,SWE,Swimming,1988,0,1,0,1
5635,SWE,Shooting,1988,0,1,0,1
5636,SWE,Cycling,1988,0,0,4,4
5637,SWE,Table Tennis,1988,0,0,1,1
5638,SWE,Wrestling,1992,0,1,1,2
5639,SWE,Athletics,1992,0,1,0,1
5640,SWE,Swimming,1992,0,5,1,6
5641,SWE,Shooting,1992,0,0,1,1
5642,SWE,Canoeing,1992,0,4,4,8
5643,SWE,Handball,1992,0,16,0,16
5644,SWE,Table Tennis,1992,1,0,0,1
5645,SWE,Sailing,1996,0,2,0,2
5646,SWE,Wrestling,1996,0,0,1,1
5647,SWE,Athletics,1996,1,0,0,1
5648,SWE,Swimming,1996,0,4,0,4
5649,SWE,Canoeing,1996,2,0,4,6
5650,SWE,Archery,1996,0,1,0,1
5651,SWE,Handball,1996,0,16,0,16
5652,SWE,Sailing,2000,0,0,1,1
5653,SWE,Wrestling,2000,1,0,0,1
5654,SWE,Athletics,2000,0,0,1,1
5655,SWE,Swimming,2000,1,2,6,9
5656,SWE,Shooting,2000,2,0,0,2
5657,SWE,Canoeing,2000,0,2,0,2
5658,SWE,Handball,2000,0,15,0,15
5659,SWE,Table Tennis,2000,0,1,0,1
5660,SWE,Sailing,2004,0,0,2,2
5661,SWE,Wrestling,2004,0,1,0,1
5662,SWE,Athletics,2004,3,0,0,3
5663,SWE,Equestrianism,2004,0,4,0,4
5664,SWE,Canoeing,2004,2,0,0,2
5665,SWE,Sailing,2008,0,0,2,2
5666,SWE,Tennis,2008,0,2,0,2
5667,SWE,Equestrianism,2008,0,1,0,1
5668,SWE,Cycling,2008,0,2,0,2
5669,SWE,Sailing,2012,2,0,1,3
5670,SWE,Wrestling,2012,0,0,2,2
5671,SWE,Shooting,2012,0,1,0,1
5672,SWE,Equestrianism,2012,0,1,0,1
5673,SWE,Triathlon,2012,0,1,0,1
5674,SWE,Handball,2012,0,14,0,14
5675,SWE,Wrestling,2016,0,0,2,2
5676,SWE,Swimming,2016,1,1,1,3
5677,SWE,Football,2016,0,18,0,18
5678,SWE,Shooting,2016,0,1,0,1
5679,SWE,Equestrianism,2016,0,1,0,1
5680,SWE,Cycling,2016,1,1,0,2
5681,SWE,Golf,2016,0,1,0,1
5682,SWE,Sailing,2020,0,3,0,3
5683,SWE,Athletics,2020,2,1,0,3
5684,SWE,Swimming,2020,0,1,0,1
5685,SWE,Football,2020,0,22,0,22
5686,SWE,Equestrian,2020,4,1,0,5
5687,SWE,Sailing,2024,0,2,2,4
5688,SWE,Athletics,2024,1,0,0,1
5689,SWE,Judo,2024,0,0,1,1
5690,SWE,Swimming,2024,2,0,0,2
5691,SWE,Shooting,2024,0,1,0,1
5692,SWE,Beach Volleyball,2024,2,0,0,2
5693,SWE,Table Tennis,2024,0,4,0,4
5694,SWE,Cycling Mountain Bike,2024,0,0,1,1
5695,SYR,Wrestling,1984,0,1,0,1
5696,SYR,Athletics,1996,1,0,0,1
5697,SYR,Boxing,2004,0,0,1,1
5698,SYR,Weightlifting,2020,0,0,1,1
5699,TAN,Athletics,1980,0,2,0,2
5700,TCH,Tennis,1920,0,0,2,2
5701,TCH,Ice Hockey,1920,0,0,8,8
5702,TCH,Weightlifting,1924,0,0,1,1
5703,TCH,Gymnastics,1924,1,4,4,9
5704,TCH,Weightlifting,1928,0,0,1,1
5705,TCH,Wrestling,1928,0,1,0,1
5706,TCH,Boxing,1928,0,1,0,1
5707,TCH,Equestrianism,1928,1,0,0,1
5708,TCH,Gymnastics,1928,1,10,1,12
5709,TCH,Weightlifting,1932,1,1,0,2
5710,TCH,Wrestling,1932,0,1,0,1
5711,TCH,Athletics,1932,0,0,1,1
5712,TCH,Art Competitions,1932,0,1,1,2
5713,TCH,Weightlifting,1936,0,1,0,1
5714,TCH,Wrestling,1936,0,2,0,2
5715,TCH,Canoeing,1936,4,1,0,5
5716,TCH,Gymnastics,1936,1,8,0,9
5717,TCH,Art Competitions,1936,0,0,1,1
5718,TCH,Boxing,1948,1,0,0,1
5719,TCH,Athletics,1948,1,1,0,2
5720,TCH,Canoeing,1948,4,2,0,6
5721,TCH,Gymnastics,1948,8,0,3,11
5722,TCH,Rowing,1952,5,0,0,5
5723,TCH,Wrestling,1952,0,1,1,2
5724,TCH,Boxing,1952,1,0,0,1
5725,TCH,Athletics,1952,4,1,0,5
5726,TCH,Canoeing,1952,1,2,1,4
5727,TCH,Gymnastics,1952,0,0,8,8
5728,TCH,Athletics,1956,1,0,1,2
5729,TCH,Shooting,1956,0,1,0,1
5730,TCH,Cycling,1956,0,3,0,3
5731,TCH,Gymnastics,1956,0,1,0,1
5732,TCH,Rowing,1960,2,0,9,11
5733,TCH,Wrestling,1960,0,0,1,1
5734,TCH,Boxing,1960,1,0,1,2
5735,TCH,Athletics,1960,0,1,0,1
5736,TCH,Gymnastics,1960,1,6,0,7
5737,TCH,Rowing,1964,0,0,11,11
5738,TCH,Weightlifting,1964,1,0,0,1
5739,TCH,Wrestling,1964,0,1,0,1
5740,TCH,Athletics,1964,0,2,0,2
5741,TCH,Football,1964,0,17,0,17
5742,TCH,Shooting,1964,0,0,1,1
5743,TCH,Volleyball,1964,0,11,0,11
5744,TCH,Cycling,1964,1,0,0,1
5745,TCH,Gymnastics,1964,3,6,0,9
5746,TCH,Wrestling,1968,0,0,2,2
5747,TCH,Athletics,1968,1,0,1,2
5748,TCH,Shooting,1968,1,0,0,1
5749,TCH,Volleyball,1968,0,0,12,12
5750,TCH,Diving,1968,1,0,0,1
5751,TCH,Gymnastics,1968,4,7,0,11
5752,TCH,Rowing,1972,0,3,5,8
5753,TCH,Wrestling,1972,1,0,0,1
5754,TCH,Athletics,1972,1,0,1,2
5755,TCH,Shooting,1972,0,1,0,1
5756,TCH,Diving,1972,0,1,0,1
5757,TCH,Handball,1972,0,16,0,16
5758,TCH,Rowing,1976,0,0,7,7
5759,TCH,Wrestling,1976,0,1,0,1
5760,TCH,Athletics,1976,0,0,1,1
5761,TCH,Shooting,1976,1,0,0,1
5762,TCH,Cycling,1976,1,0,0,1
5763,TCH,Modern Pentathlon,1976,0,3,1,4
5764,TCH,Rowing,1980,0,0,2,2
5765,TCH,Weightlifting,1980,1,0,1,2
5766,TCH,Wrestling,1980,0,0,2,2
5767,TCH,Boxing,1980,0,0,1,1
5768,TCH,Athletics,1980,0,2,0,2
5769,TCH,Judo,1980,0,0,1,1
5770,TCH,Football,1980,16,0,0,16
5771,TCH,Hockey,1980,0,16,0,16
5772,TCH,Cycling,1980,0,0,8,8
5773,TCH,Gymnastics,1980,0,0,1,1
5774,TCH,Tennis,1988,1,2,2,5
5775,TCH,Wrestling,1988,0,0,1,1
5776,TCH,Athletics,1988,1,1,0,2
5777,TCH,Shooting,1988,1,1,0,2
5778,TCH,Rowing,1992,0,1,0,1
5779,TCH,Athletics,1992,2,0,0,2
5780,TCH,Shooting,1992,1,0,1,2
5781,TCH,Canoeing,1992,1,2,0,3
5782,TGA,Boxing,1996,0,1,0,1
5783,THA,Boxing,1976,0,0,1,1
5784,THA,Boxing,1984,0,1,0,1
5785,THA,Boxing,1988,0,0,1,1
5786,THA,Boxing,1992,0,0,1,1
5787,THA,Boxing,1996,1,0,1,2
5788,THA,Weightlifting,2000,0,0,1,1
5789,THA,Boxing,2000,1,0,1,2
5790,THA,Taekwondo,2004,0,0,1,1
5791,THA,Weightlifting,2004,2,0,2,4
5792,THA,Boxing,2004,1,1,1,3
5793,THA,Taekwondo,2008,0,1,0,1
5794,THA,Weightlifting,2008,1,0,0,1
5795,THA,Boxing,2008,1,1,0,2
5796,THA,Taekwondo,2012,0,0,1,1
5797,THA,Weightlifting,2012,0,1,0,1
5798,THA,Boxing,2012,0,1,0,1
5799,THA,Taekwondo,2016,0,1,1,2
5800,THA,Weightlifting,2016,2,1,1,4
5801,THA,Taekwondo,2020,1,0,0,1
5802,THA,Boxing,2020,0,0,1,1
5803,THA,Taekwondo,2024,1,0,0,1
5804,THA,Weightlifting,2024,0,2,1,3
5805,THA,Boxing,2024,0,0,1,1
5806,THA,Badminton,2024,0,1,0,1
5807,TJK,Wrestling,2008,0,1,0,1
5808,TJK,Judo,2008,0,0,1,1
5809,TJK,Boxing,2012,0,0,1,1
5810,TJK,Athletics,2016,1,0,0,1
5811,TJK,Boxing,2024,0,0,1,1
5812,TJK,Judo,2024,0,0,2,2
5813,TKM,Weightlifting,2020,0,1,0,1
5814,TOG,Canoeing,2008,0,0,1,1
5815,TPE,Athletics,1960,0,1,0,1
5816,TPE,Athletics,1968,0,0,1,1
5817,TPE,Weightlifting,1984,0,0,1,1
5818,TPE,Baseball,1992,0,20,0,20
5819,TPE,Table Tennis,1996,0,1,0,1
5820,TPE,Taekwondo,2000,0,0,2,2
5821,TPE,Weightlifting,2000,0,1,1,2
5822,TPE,Table Tennis,2000,0,0,1,1
5823,TPE,Taekwondo,2004,2,1,0,3
5824,TPE,Archery,2004,0,3,3,6
5825,TPE,Taekwondo,2008,0,0,2,2
5826,TPE,Weightlifting,2008,0,0,2,2
5827,TPE,Taekwondo,2012,0,0,1,1
5828,TPE,Weightlifting,2012,0,1,0,1
5829,TPE,Weightlifting,2016,1,0,1,2
5830,TPE,Archery,2016,0,0,3,3
5831,TPE,Taekwondo,2020,0,0,1,1
5832,TPE,Weightlifting,2020,1,0,1,2
5833,TPE,Boxing,2020,0,0,1,1
5834,TPE,Judo,2020,0,1,0,1
5835,TPE,Artistic Gymnastics,2020,0,1,0,1
5836,TPE,Archery,2020,0,3,0,3
5837,TPE,Karate,2020,0,0,1,1
5838,TPE,Golf,2020,0,0,1,1
5839,TPE,Table Tennis,2020,0,0,2,2
5840,TPE,Badminton,2020,2,1,0,3
5841,TPE,Weightlifting,2024,0,0,1,1
5842,TPE,Boxing,2024,1,0,2,3
5843,TPE,Artistic Gymnastics,2024,0,0,1,1
5844,TPE,Shooting,2024,0,0,1,1
5845,TPE,Badminton,2024,2,0,0,2
5846,TTO,Weightlifting,1948,0,1,0,1
5847,TTO,Weightlifting,1952,0,0,2,2
5848,TTO,Athletics,1964,0,1,5,6
5849,TTO,Athletics,1976,1,0,0,1
5850,TTO,Athletics,1996,0,0,2,2
5851,TTO,Athletics,2000,0,1,1,2
5852,TTO,Swimming,2004,0,0,1,1
5853,TTO,Athletics,2008,5,1,0,6
5854,TTO,Athletics,2012,1,4,5,10
5855,TTO,Athletics,2016,0,0,1,1
5856,TUN,Boxing,1964,0,0,1,1
5857,TUN,Athletics,1964,0,1,0,1
5858,TUN,Athletics,1968,1,0,1,2
5859,TUN,Athletics,1972,0,1,0,1
5860,TUN,Boxing,1996,0,0,1,1
5861,TUN,Swimming,2008,1,0,0,1
5862,TUN,Athletics,2012,0,1,0,1
5863,TUN,Swimming,2012,1,0,1,2
5864,TUN,Taekwondo,2016,0,0,1,1
5865,TUN,Wrestling,2016,0,0,1,1
5866,TUN,Fencing,2016,0,0,1,1
5867,TUN,Taekwondo,2020,0,1,0,1
5868,TUN,Swimming,2020,1,0,0,1
5869,TUN,Taekwondo,2024,1,0,1,2
5870,TUN,Fencing,2024,0,1,0,1
5871,TUR,Wrestling,1936,1,0,1,2
5872,TUR,Wrestling,1948,6,4,1,11
5873,TUR,Athletics,1948,0,0,1,1
5874,TUR,Wrestling,1952,2,0,1,3
5875,TUR,Wrestling,1956,3,2,2,7
5876,TUR,Wrestling,1960,7,2,0,9
5877,TUR,Wrestling,1964,2,3,1,6
5878,TUR,Wrestling,1968,2,0,0,2
5879,TUR,Wrestling,1972,0,1,0,1
5880,TUR,Wrestling,1984,0,0,1,1
5881,TUR,Boxing,1984,0,0,2,2
5882,TUR,Weightlifting,1988,1,0,0,1
5883,TUR,Wrestling,1988,0,1,0,1
5884,TUR,Weightlifting,1992,1,0,0,1
5885,TUR,Wrestling,1992,1,2,1,4
5886,TUR,Judo,1992,0,0,1,1
5887,TUR,Weightlifting,1996,2,0,0,2
5888,TUR,Wrestling,1996,2,0,1,3
5889,TUR,Boxing,1996,0,1,0,1
5890,TUR,Taekwondo,2000,0,0,1,1
5891,TUR,Weightlifting,2000,1,0,0,1
5892,TUR,Wrestling,2000,1,0,1,2
5893,TUR,Judo,2000,1,0,0,1
5894,TUR,Taekwondo,2004,0,1,0,1
5895,TUR,Weightlifting,2004,3,0,2,5
5896,TUR,Wrestling,2004,0,1,2,3
5897,TUR,Boxing,2004,0,1,0,1
5898,TUR,Athletics,2004,0,0,1,1
5899,TUR,Taekwondo,2008,0,1,1,2
5900,TUR,Weightlifting,2008,0,1,0,1
5901,TUR,Wrestling,2008,1,0,1,2
5902,TUR,Boxing,2008,0,0,1,1
5903,TUR,Athletics,2008,0,1,0,1
5904,TUR,Taekwondo,2012,1,1,0,2
5905,TUR,Wrestling,2012,0,0,1,1
5906,TUR,Athletics,2012,1,1,0,2
5907,TUR,Taekwondo,2016,0,0,1,1
5908,TUR,Weightlifting,2016,0,1,0,1
5909,TUR,Wrestling,2016,1,2,2,5
5910,TUR,Athletics,2016,0,0,1,1
5911,TUR,Taekwondo,2020,0,0,2,2
5912,TUR,Wrestling,2020,0,0,3,3
5913,TUR,Boxing,2020,1,1,0,2
5914,TUR,Artistic Gymnastics,2020,0,0,1,1
5915,TUR,Archery,2020,1,0,0,1
5916,TUR,Karate,2020,0,1,3,4
5917,TUR,Taekwondo,2024,0,0,1,1
5918,TUR,Wrestling,2024,0,0,2,2
5919,TUR,Boxing,2024,0,2,1,3
5920,TUR,Shooting,2024,0,2,0,2
5921,TUR,Archery,2024,0,0,3,3
5922,UAE,Shooting,2004,1,0,0,1
5923,UAE,Judo,2016,0,0,1,1
5924,UAR,Wrestling,1960,0,1,0,1
5925,UAR,Boxing,1960,0,0,1,1
5926,UGA,Boxing,1968,0,1,1,2
5927,UGA,Boxing,1972,0,1,0,1
5928,UGA,Athletics,1972,1,0,0,1
5929,UGA,Boxing,1980,0,1,0,1
5930,UGA,Athletics,1996,0,0,1,1
5931,UGA,Athletics,2012,1,0,0,1
5932,UGA,Athletics,2020,2,1,1,4
5933,UGA,Athletics,2024,1,1,0,2
5934,UKR,Sailing,1996,2,0,2,4
5935,UKR,Rowing,1996,0,4,0,4
5936,UKR,Weightlifting,1996,1,0,1,2
5937,UKR,Wrestling,1996,1,0,3,4
5938,UKR,Boxing,1996,1,0,1,2
5939,UKR,Athletics,1996,1,0,3,4
5940,UKR,Archery,1996,0,0,1,1
5941,UKR,Gymnastics,1996,3,1,7,11
5942,UKR,Rhythmic Gymnastics,1996,1,0,1,2
5943,UKR,Sailing,2000,0,0,2,2
5944,UKR,Wrestling,2000,0,2,0,2
5945,UKR,Boxing,2000,0,2,3,5
5946,UKR,Athletics,2000,0,0,2,2
5947,UKR,Judo,2000,0,0,1,1
5948,UKR,Swimming,2000,2,2,0,4
5949,UKR,Shooting,2000,1,0,0,1
5950,UKR,Cycling,2000,0,4,1,5
5951,UKR,Diving,2000,0,0,2,2
5952,UKR,Archery,2000,0,3,0,3
5953,UKR,Trampolining,2000,0,1,0,1
5954,UKR,Gymnastics,2000,0,6,1,7
5955,UKR,Sailing,2004,0,5,0,5
5956,UKR,Rowing,2004,0,0,4,4
5957,UKR,Weightlifting,2004,1,1,0,2
5958,UKR,Wrestling,2004,2,0,0,2
5959,UKR,Athletics,2004,0,1,2,3
5960,UKR,Judo,2004,0,1,0,1
5961,UKR,Swimming,2004,2,0,1,3
5962,UKR,Fencing,2004,0,0,1,1
5963,UKR,Shooting,2004,1,0,0,1
5964,UKR,Canoeing,2004,0,0,4,4
5965,UKR,Archery,2004,0,0,3,3
5966,UKR,Trampolining,2004,1,0,0,1
5967,UKR,Gymnastics,2004,1,0,0,1
5968,UKR,Handball,2004,0,0,15,15
5969,UKR,Rhythmic Gymnastics,2004,0,0,1,1
5970,UKR,Weightlifting,2008,0,1,1,2
5971,UKR,Wrestling,2008,0,2,3,5
5972,UKR,Boxing,2008,1,0,1,2
5973,UKR,Athletics,2008,1,1,3,5
5974,UKR,Judo,2008,0,0,1,1
5975,UKR,Fencing,2008,4,0,0,4
5976,UKR,Shooting,2008,2,1,0,3
5977,UKR,Cycling,2008,0,0,1,1
5978,UKR,Diving,2008,0,0,2,2
5979,UKR,Canoeing,2008,1,0,1,2
5980,UKR,Archery,2008,1,0,0,1
5981,UKR,Modern Pentathlon,2008,0,0,1,1
5982,UKR,Gymnastics,2008,0,0,1,1
5983,UKR,Rhythmic Gymnastics,2008,0,0,1,1
5984,UKR,Rowing,2012,4,0,0,4
5985,UKR,Weightlifting,2012,1,0,1,2
5986,UKR,Wrestling,2012,0,1,0,1
5987,UKR,Boxing,2012,2,1,2,5
5988,UKR,Athletics,2012,0,1,5,6
5989,UKR,Fencing,2012,1,0,1,2
5990,UKR,Shooting,2012,0,0,2,2
5991,UKR,Canoeing,2012,1,2,0,3
5992,UKR,Gymnastics,2012,0,0,1,1
5993,UKR,Wrestling,2016,0,1,0,1
5994,UKR,Athletics,2016,0,0,1,1
5995,UKR,Fencing,2016,0,4,1,5
5996,UKR,Shooting,2016,0,1,0,1
5997,UKR,Canoeing,2016,1,0,2,3
5998,UKR,Modern Pentathlon,2016,0,1,0,1
5999,UKR,Gymnastics,2016,1,1,0,2
6000,UKR,Rhythmic Gymnastics,2016,0,0,1,1
6001,UKR,Tennis,2020,0,0,1,1
6002,UKR,Wrestling,2020,1,1,2,4
6003,UKR,Boxing,2020,0,1,0,1
6004,UKR,Athletics,2020,0,0,1,1
6005,UKR,Judo,2020,0,0,1,1
6006,UKR,Swimming,2020,0,1,1,2
6007,UKR,Fencing,2020,0,0,1,1
6008,UKR,Shooting,2020,0,0,2,2
6009,UKR,Canoe Sprint,2020,0,2,1,3
6010,UKR,Cycling Track,2020,0,1,0,1
6011,UKR,Karate,2020,0,1,1,2
6012,UKR,Artistic Swimming,2020,0,0,10,10
6013,UKR,Wrestling,2024,0,2,1,3
6014,UKR,Boxing,2024,1,0,0,1
6015,UKR,Athletics,2024,1,0,2,3
6016,UKR,Artistic Gymnastics,2024,0,1,0,1
6017,UKR,Fencing,2024,4,0,1,5
6018,UKR,Shooting,2024,0,1,0,1
6019,UKR,Canoe Sprint,2024,0,2,0,2
6020,URS,Rowing,1952,1,11,0,12
6021,URS,Weightlifting,1952,3,3,1,7
6022,URS,Wrestling,1952,6,2,2,10
6023,URS,Boxing,1952,0,2,4,6
6024,URS,Athletics,1952,2,11,7,20
6025,URS,Shooting,1952,1,1,2,4
6026,URS,Basketball,1952,0,14,0,14
6027,URS,Canoeing,1952,0,0,1,1
6028,URS,Gymnastics,1952,23,18,2,43
6029,URS,Rowing,1956,3,2,3,8
6030,URS,Weightlifting,1956,3,4,0,7
6031,URS,Wrestling,1956,6,2,5,13
6032,URS,Boxing,1956,3,1,2,6
6033,URS,Athletics,1956,5,10,10,25
6034,URS,Swimming,1956,0,0,5,5
6035,URS,Fencing,1956,0,0,6,6
6036,URS,Football,1956,18,0,0,18
6037,URS,Shooting,1956,3,4,1,8
6038,URS,Basketball,1956,0,12,0,12
6039,URS,Canoeing,1956,3,5,2,10
6040,URS,Water Polo,1956,0,0,10,10
6041,URS,Modern Pentathlon,1956,3,0,0,3
6042,URS,Gymnastics,1956,21,6,11,38
6043,URS,Sailing,1960,2,1,0,3
6044,URS,Rowing,1960,3,5,4,12
6045,URS,Weightlifting,1960,5,1,0,6
6046,URS,Wrestling,1960,3,2,5,10
6047,URS,Boxing,1960,1,2,2,5
6048,URS,Athletics,1960,11,8,5,24
6049,URS,Fencing,1960,12,2,6,20
6050,URS,Shooting,1960,2,2,3,7
6051,URS,Equestrianism,1960,1,0,0,1
6052,URS,Basketball,1960,0,12,0,12
6053,URS,Cycling,1960,1,0,11,12
6054,URS,Diving,1960,0,0,1,1
6055,URS,Canoeing,1960,5,1,0,6
6056,URS,Water Polo,1960,0,11,0,11
6057,URS,Modern Pentathlon,1960,0,3,0,3
6058,URS,Gymnastics,1960,15,13,8,36
6059,URS,Rowing,1964,3,0,0,3
6060,URS,Weightlifting,1964,4,3,0,7
6061,URS,Wrestling,1964,3,4,3,10
6062,URS,Boxing,1964,3,4,2,9
6063,URS,Athletics,1964,5,2,11,18
6064,URS,Judo,1964,0,0,4,4
6065,URS,Swimming,1964,1,1,6,8
6066,URS,Fencing,1964,11,5,2,18
6067,URS,Shooting,1964,0,2,0,2
6068,URS,Equestrianism,1964,0,0,4,4
6069,URS,Volleyball,1964,11,12,0,23
6070,URS,Basketball,1964,0,12,0,12
6071,URS,Cycling,1964,0,2,0,2
6072,URS,Diving,1964,0,0,1,1
6073,URS,Canoeing,1964,7,0,1,8
6074,URS,Water Polo,1964,0,0,11,11
6075,URS,Modern Pentathlon,1964,3,1,1,5
6076,URS,Gymnastics,1964,9,15,5,29
6077,URS,Sailing,1968,1,0,0,1
6078,URS,Rowing,1968,2,0,9,11
6079,URS,Weightlifting,1968,3,3,0,6
6080,URS,Wrestling,1968,3,5,1,9
6081,URS,Boxing,1968,3,2,1,6
6082,URS,Athletics,1968,3,2,11,16
6083,URS,Swimming,1968,0,8,14,22
6084,URS,Fencing,1968,11,12,0,23
6085,URS,Shooting,1968,2,1,2,5
6086,URS,Equestrianism,1968,1,3,0,4
6087,URS,Volleyball,1968,23,0,0,23
6088,URS,Basketball,1968,0,0,12,12
6089,URS,Diving,1968,0,2,0,2
6090,URS,Canoeing,1968,3,1,5,9
6091,URS,Water Polo,1968,0,11,0,11
6092,URS,Modern Pentathlon,1968,0,3,1,4
6093,URS,Gymnastics,1968,10,10,8,28
6094,URS,Sailing,1972,2,0,1,3
6095,URS,Rowing,1972,3,0,0,3
6096,URS,Weightlifting,1972,3,1,1,5
6097,URS,Wrestling,1972,9,4,1,14
6098,URS,Boxing,1972,2,0,0,2
6099,URS,Athletics,1972,9,10,1,20
6100,URS,Judo,1972,1,1,2,4
6101,URS,Swimming,1972,0,6,8,14
6102,URS,Fencing,1972,6,10,7,23
6103,URS,Football,1972,0,0,19,19
6104,URS,Shooting,1972,1,2,1,4
6105,URS,Equestrianism,1972,3,1,0,4
6106,URS,Volleyball,1972,12,0,12,24
6107,URS,Basketball,1972,12,0,0,12
6108,URS,Cycling,1972,6,0,1,7
6109,URS,Diving,1972,1,0,0,1
6110,URS,Canoeing,1972,12,0,0,12
6111,URS,Archery,1972,0,0,1,1
6112,URS,Water Polo,1972,11,0,0,11
6113,URS,Modern Pentathlon,1972,3,1,1,5
6114,URS,Gymnastics,1972,11,11,4,26
6115,URS,Sailing,1976,0,3,0,3
6116,URS,Rowing,1976,6,21,12,39
6117,URS,Weightlifting,1976,7,1,0,8
6118,URS,Wrestling,1976,12,5,1,18
6119,URS,Boxing,1976,0,1,4,5
6120,URS,Athletics,1976,4,4,19,27
6121,URS,Judo,1976,2,2,1,5
6122,URS,Swimming,1976,1,8,5,14
6123,URS,Fencing,1976,11,2,2,15
6124,URS,Football,1976,0,0,15,15
6125,URS,Shooting,1976,1,1,1,3
6126,URS,Volleyball,1976,0,24,0,24
6127,URS,Basketball,1976,12,0,12,24
6128,URS,Cycling,1976,4,4,0,8
6129,URS,Diving,1976,1,0,2,3
6130,URS,Canoeing,1976,13,4,0,17
6131,URS,Archery,1976,0,1,1,2
6132,URS,Modern Pentathlon,1976,0,1,0,1
6133,URS,Gymnastics,1976,12,13,2,27
6134,URS,Handball,1976,28,0,0,28
6135,URS,Sailing,1980,2,3,1,6
6136,URS,Rowing,1980,2,35,15,52
6137,URS,Weightlifting,1980,5,3,0,8
6138,URS,Wrestling,1980,12,3,2,17
6139,URS,Boxing,1980,1,6,1,8
6140,URS,Athletics,1980,27,17,12,56
6141,URS,Judo,1980,2,1,2,5
6142,URS,Swimming,1980,14,16,10,40
6143,URS,Fencing,1980,7,11,6,24
6144,URS,Football,1980,0,0,17,17
6145,URS,Shooting,1980,3,1,1,5
6146,URS,Equestrianism,1980,11,3,2,16
6147,URS,Volleyball,1980,23,0,0,23
6148,URS,Hockey,1980,0,0,32,32
6149,URS,Basketball,1980,12,0,12,24
6150,URS,Cycling,1980,10,1,2,13
6151,URS,Diving,1980,2,2,2,6
6152,URS,Canoeing,1980,6,3,3,12
6153,URS,Archery,1980,1,2,0,3
6154,URS,Water Polo,1980,11,0,0,11
6155,URS,Modern Pentathlon,1980,4,0,1,5
6156,URS,Gymnastics,1980,19,8,5,32
6157,URS,Handball,1980,13,14,0,27
6158,URS,Sailing,1988,0,2,2,4
6159,URS,Rowing,1988,0,13,2,15
6160,URS,Weightlifting,1988,6,2,0,8
6161,URS,Wrestling,1988,8,4,3,15
6162,URS,Boxing,1988,1,1,2,4
6163,URS,Athletics,1988,17,6,13,36
6164,URS,Judo,1988,0,1,4,5
6165,URS,Swimming,1988,2,7,12,21
6166,URS,Fencing,1988,5,5,7,17
6167,URS,Football,1988,18,0,0,18
6168,URS,Shooting,1988,4,1,6,11
6169,URS,Volleyball,1988,12,12,0,24
6170,URS,Basketball,1988,12,0,12,24
6171,URS,Cycling,1988,8,1,2,11
6172,URS,Canoeing,1988,5,7,0,12
6173,URS,Archery,1988,0,0,1,1
6174,URS,Water Polo,1988,0,0,13,13
6175,URS,Modern Pentathlon,1988,0,0,1,1
6176,URS,Gymnastics,1988,21,5,3,29
6177,URS,Handball,1988,14,0,15,29
6178,URS,Rhythmic Gymnastics,1988,1,0,1,2
6179,URU,Football,1924,14,0,0,14
6180,URU,Football,1928,17,0,0,17
6181,URU,Rowing,1932,0,0,1,1
6182,URU,Rowing,1948,0,1,2,3
6183,URU,Rowing,1952,0,0,2,2
6184,URU,Basketball,1952,0,0,12,12
6185,URU,Basketball,1956,0,0,12,12
6186,URU,Boxing,1964,0,0,1,1
6187,URU,Cycling,2000,0,1,0,1
6188,USA,Athletics,1896,9,6,2,17
6189,USA,Shooting,1896,2,1,0,3
6190,USA,Sailing,1900,0,0,2,2
6191,USA,Rowing,1900,9,0,0,9
6192,USA,Tennis,1900,0,1,2,3
6193,USA,Athletics,1900,16,13,10,39
6194,USA,Rugby,1900,1,0,0,1
6195,USA,Polo,1900,2,1,1,4
6196,USA,Cycling,1900,0,0,1,1
6197,USA,Golf,1900,2,1,1,4
6198,USA,Rowing,1904,18,9,9,36
6199,USA,Tennis,1904,3,3,6,12
6200,USA,Weightlifting,1904,1,2,0,3
6201,USA,Wrestling,1904,5,6,6,17
6202,USA,Boxing,1904,7,7,4,18
6203,USA,Athletics,1904,26,25,21,72
6204,USA,Swimming,1904,7,7,8,22
6205,USA,Fencing,1904,2,7,4,13
6206,USA,Football,1904,0,11,12,23
6207,USA,Cycling,1904,7,7,7,21
6208,USA,Diving,1904,1,0,1,2
6209,USA,Archery,1904,12,8,8,28
6210,USA,Water Polo,1904,7,7,7,21
6211,USA,Gymnastics,1904,16,13,15,44
6212,USA,Tug-Of-War,1904,5,5,4,14
6213,USA,Golf,1904,10,11,12,33
6214,USA,Lacrosse,1904,0,12,0,12
6215,USA,Roque,1904,1,1,1,3
6216,USA,Athletics,1906,11,6,6,23
6217,USA,Swimming,1906,1,0,0,1
6218,USA,Wrestling,1908,2,0,0,2
6219,USA,Athletics,1908,19,14,8,41
6220,USA,Swimming,1908,1,0,4,5
6221,USA,Shooting,1908,11,2,1,14
6222,USA,Diving,1908,0,0,1,1
6223,USA,Archery,1908,0,0,1,1
6224,USA,Jeu De Paume,1908,1,0,0,1
6225,USA,Athletics,1912,23,14,12,49
6226,USA,Swimming,1912,2,4,1,7
6227,USA,Shooting,1912,20,7,9,36
6228,USA,Equestrianism,1912,0,0,4,4
6229,USA,Cycling,1912,0,0,10,10
6230,USA,Art Competitions,1912,1,0,0,1
6231,USA,Rowing,1920,12,5,0,17
6232,USA,Wrestling,1920,1,2,3,6
6233,USA,Boxing,1920,3,0,1,4
6234,USA,Athletics,1920,16,12,8,36
6235,USA,Rugby,1920,16,0,0,16
6236,USA,Swimming,1920,14,5,3,22
6237,USA,Polo,1920,0,0,4,4
6238,USA,Fencing,1920,0,0,5,5
6239,USA,Shooting,1920,46,8,10,64
6240,USA,Diving,1920,3,2,3,8
6241,USA,Ice Hockey,1920,0,11,0,11
6242,USA,Figure Skating,1920,0,0,1,1
6243,USA,Rowing,1924,11,1,8,20
6244,USA,Tennis,1924,8,2,0,10
6245,USA,Wrestling,1924,4,1,1,6
6246,USA,Boxing,1924,2,2,2,6
6247,USA,Athletics,1924,18,15,15,48
6248,USA,Rugby,1924,19,0,0,19
6249,USA,Swimming,1924,16,5,5,26
6250,USA,Polo,1924,0,4,0,4
6251,USA,Shooting,1924,14,2,5,21
6252,USA,Equestrianism,1924,0,0,1,1
6253,USA,Diving,1924,4,4,3,11
6254,USA,Water Polo,1924,0,0,9,9
6255,USA,Gymnastics,1924,1,0,0,1
6256,USA,Rowing,1928,11,5,2,18
6257,USA,Wrestling,1928,1,1,0,2
6258,USA,Boxing,1928,0,2,1,3
6259,USA,Athletics,1928,15,11,8,34
6260,USA,Swimming,1928,16,2,3,21
6261,USA,Fencing,1928,0,0,1,1
6262,USA,Diving,1928,4,3,2,9
6263,USA,Sailing,1932,14,5,0,19
6264,USA,Rowing,1932,14,1,0,15
6265,USA,Weightlifting,1932,0,0,2,2
6266,USA,Wrestling,1932,3,2,0,5
6267,USA,Boxing,1932,2,0,3,5
6268,USA,Athletics,1932,25,13,6,44
6269,USA,Swimming,1932,8,5,3,16
6270,USA,Fencing,1932,0,1,12,13
6271,USA,Equestrianism,1932,3,2,4,9
6272,USA,Hockey,1932,0,0,14,14
6273,USA,Diving,1932,4,4,4,12
6274,USA,Water Polo,1932,0,0,7,7
6275,USA,Modern Pentathlon,1932,0,0,1,1
6276,USA,Gymnastics,1932,5,10,5,20
6277,USA,Art Competitions,1932,3,4,0,7
6278,USA,Rowing,1936,9,0,1,10
6279,USA,Weightlifting,1936,1,0,0,1
6280,USA,Wrestling,1936,1,3,0,4
6281,USA,Boxing,1936,0,1,1,2
6282,USA,Athletics,1936,20,10,4,34
6283,USA,Swimming,1936,2,8,7,17
6284,USA,Equestrianism,1936,0,1,0,1
6285,USA,Basketball,1936,14,0,0,14
6286,USA,Diving,1936,4,4,2,10
6287,USA,Canoeing,1936,0,0,1,1
6288,USA,Modern Pentathlon,1936,0,1,0,1
6289,USA,Art Competitions,1936,0,1,0,1
6290,USA,Sailing,1948,7,1,2,10
6291,USA,Rowing,1948,14,0,4,18
6292,USA,Weightlifting,1948,4,3,1,8
6293,USA,Wrestling,1948,2,1,1,4
6294,USA,Boxing,1948,0,1,0,1
6295,USA,Athletics,1948,18,5,10,33
6296,USA,Swimming,1948,18,6,1,25
6297,USA,Fencing,1948,0,0,6,6
6298,USA,Shooting,1948,1,1,0,2
6299,USA,Equestrianism,1948,3,4,0,7
6300,USA,Basketball,1948,14,0,0,14
6301,USA,Diving,1948,4,4,2,10
6302,USA,Canoeing,1948,2,3,0,5
6303,USA,Modern Pentathlon,1948,0,1,0,1
6304,USA,Gymnastics,1948,0,0,8,8
6305,USA,Sailing,1952,10,2,0,12
6306,USA,Rowing,1952,11,0,5,16
6307,USA,Weightlifting,1952,4,2,0,6
6308,USA,Wrestling,1952,1,2,1,4
6309,USA,Boxing,1952,5,0,0,5
6310,USA,Athletics,1952,21,13,6,40
6311,USA,Swimming,1952,11,2,6,19
6312,USA,Shooting,1952,1,0,1,2
6313,USA,Equestrianism,1952,0,0,6,6
6314,USA,Basketball,1952,14,0,0,14
6315,USA,Diving,1952,4,2,3,9
6316,USA,Canoeing,1952,1,0,0,1
6317,USA,Sailing,1956,2,0,1,3
6318,USA,Rowing,1956,14,6,1,21
6319,USA,Weightlifting,1956,4,2,1,7
6320,USA,Wrestling,1956,0,1,1,2
6321,USA,Boxing,1956,2,1,0,3
6322,USA,Athletics,1956,22,10,8,40
6323,USA,Swimming,1956,2,15,5,22
6324,USA,Shooting,1956,0,0,1,1
6325,USA,Basketball,1956,12,0,0,12
6326,USA,Diving,1956,3,4,2,9
6327,USA,Modern Pentathlon,1956,0,3,0,3
6328,USA,Sailing,1960,3,0,2,5
6329,USA,Rowing,1960,4,0,3,7
6330,USA,Weightlifting,1960,1,4,1,6
6331,USA,Wrestling,1960,3,0,0,3
6332,USA,Boxing,1960,3,0,1,4
6333,USA,Athletics,1960,18,8,6,32
6334,USA,Swimming,1960,34,3,3,40
6335,USA,Fencing,1960,0,0,1,1
6336,USA,Shooting,1960,1,1,0,2
6337,USA,Equestrianism,1960,0,3,0,3
6338,USA,Basketball,1960,12,0,0,12
6339,USA,Diving,1960,2,4,0,6
6340,USA,Modern Pentathlon,1960,0,0,4,4
6341,USA,Sailing,1964,0,3,8,11
6342,USA,Rowing,1964,12,2,5,19
6343,USA,Weightlifting,1964,0,1,1,2
6344,USA,Wrestling,1964,0,0,1,1
6345,USA,Boxing,1964,1,0,3,4
6346,USA,Athletics,1964,20,10,3,33
6347,USA,Judo,1964,0,0,1,1
6348,USA,Swimming,1964,45,8,8,61
6349,USA,Shooting,1964,2,2,3,7
6350,USA,Equestrianism,1964,0,4,0,4
6351,USA,Basketball,1964,12,0,0,12
6352,USA,Diving,1964,3,2,3,8
6353,USA,Canoeing,1964,0,2,1,3
6354,USA,Modern Pentathlon,1964,0,3,0,3
6355,USA,Sailing,1968,5,0,0,5
6356,USA,Rowing,1968,0,2,2,4
6357,USA,Weightlifting,1968,0,0,1,1
6358,USA,Wrestling,1968,0,2,0,2
6359,USA,Boxing,1968,2,1,4,7
6360,USA,Athletics,1968,24,6,7,37
6361,USA,Swimming,1968,52,15,16,83
6362,USA,Shooting,1968,1,2,0,3
6363,USA,Equestrianism,1968,1,4,1,6
6364,USA,Basketball,1968,12,0,0,12
6365,USA,Diving,1968,2,0,4,6
6366,USA,Sailing,1972,3,0,5,8
6367,USA,Rowing,1972,0,9,0,9
6368,USA,Wrestling,1972,3,2,1,6
6369,USA,Boxing,1972,1,0,3,4
6370,USA,Athletics,1972,9,11,8,28
6371,USA,Swimming,1972,48,14,12,74
6372,USA,Shooting,1972,2,2,0,4
6373,USA,Equestrianism,1972,0,8,1,9
6374,USA,Basketball,1972,0,12,0,12
6375,USA,Diving,1972,1,1,1,3
6376,USA,Canoeing,1972,0,0,1,1
6377,USA,Archery,1972,2,0,0,2
6378,USA,Water Polo,1972,0,0,11,11
6379,USA,Sailing,1976,0,5,2,7
6380,USA,Rowing,1976,0,3,9,12
6381,USA,Weightlifting,1976,0,1,0,1
6382,USA,Wrestling,1976,1,3,2,6
6383,USA,Boxing,1976,5,1,1,7
6384,USA,Athletics,1976,12,11,8,31
6385,USA,Judo,1976,0,0,1,1
6386,USA,Swimming,1976,29,19,7,55
6387,USA,Shooting,1976,2,1,0,3
6388,USA,Equestrianism,1976,5,1,3,9
6389,USA,Basketball,1976,12,12,0,24
6390,USA,Diving,1976,2,1,2,5
6391,USA,Archery,1976,2,0,0,2
6392,USA,Gymnastics,1976,0,0,1,1
6393,USA,Sailing,1984,7,6,0,13
6394,USA,Rowing,1984,11,24,3,38
6395,USA,Weightlifting,1984,0,1,1,2
6396,USA,Wrestling,1984,9,3,1,13
6397,USA,Boxing,1984,9,1,1,11
6398,USA,Athletics,1984,32,15,9,56
6399,USA,Judo,1984,0,1,1,2
6400,USA,Swimming,1984,50,13,0,63
6401,USA,Fencing,1984,0,0,1,1
6402,USA,Shooting,1984,3,1,2,6
6403,USA,Equestrianism,1984,9,2,0,11
6404,USA,Volleyball,1984,12,12,0,24
6405,USA,Hockey,1984,0,0,16,16
6406,USA,Basketball,1984,24,0,0,24
6407,USA,Cycling,1984,4,7,5,16
6408,USA,Diving,1984,2,3,3,8
6409,USA,Canoeing,1984,0,0,1,1
6410,USA,Archery,1984,1,1,0,2
6411,USA,Water Polo,1984,0,13,0,13
6412,USA,Modern Pentathlon,1984,0,3,0,3
6413,USA,Gymnastics,1984,10,10,6,26
6414,USA,Synchronized Swimming,1984,3,0,0,3
6415,USA,Sailing,1988,2,5,3,10
6416,USA,Rowing,1988,0,5,9,14
6417,USA,Tennis,1988,4,1,2,7
6418,USA,Wrestling,1988,2,1,3,6
6419,USA,Boxing,1988,3,3,2,8
6420,USA,Athletics,1988,22,12,6,40
6421,USA,Judo,1988,0,1,1,2
6422,USA,Swimming,1988,24,12,9,45
6423,USA,Shooting,1988,0,1,0,1
6424,USA,Equestrianism,1988,0,5,0,5
6425,USA,Volleyball,1988,12,0,0,12
6426,USA,Basketball,1988,12,0,12,24
6427,USA,Cycling,1988,0,0,1,1
6428,USA,Diving,1988,2,1,2,5
6429,USA,Canoeing,1988,3,0,0,3
6430,USA,Archery,1988,1,3,3,7
6431,USA,Water Polo,1988,0,13,0,13
6432,USA,Gymnastics,1988,0,0,1,1
6433,USA,Synchronized Swimming,1988,0,3,0,3
6434,USA,Sailing,1992,2,11,3,16
6435,USA,Rowing,1992,0,8,2,10
6436,USA,Tennis,1992,3,0,1,4
6437,USA,Wrestling,1992,3,3,2,8
6438,USA,Boxing,1992,1,1,1,3
6439,USA,Athletics,1992,25,13,10,48
6440,USA,Judo,1992,0,1,0,1
6441,USA,Swimming,1992,35,9,12,56
6442,USA,Shooting,1992,1,1,0,2
6443,USA,Equestrianism,1992,0,0,5,5
6444,USA,Volleyball,1992,0,0,24,24
6445,USA,Basketball,1992,12,0,12,24
6446,USA,Cycling,1992,0,0,2,2
6447,USA,Diving,1992,1,1,1,3
6448,USA,Canoeing,1992,2,0,2,4
6449,USA,Gymnastics,1992,1,2,8,11
6450,USA,Synchronized Swimming,1992,3,0,0,3
6451,USA,Sailing,1996,0,0,4,4
6452,USA,Rowing,1996,0,8,4,12
6453,USA,Tennis,1996,4,0,0,4
6454,USA,Wrestling,1996,3,4,1,8
6455,USA,Boxing,1996,1,0,5,6
6456,USA,Athletics,1996,25,9,5,39
6457,USA,Judo,1996,0,0,1,1
6458,USA,Swimming,1996,47,11,2,60
6459,USA,Football,1996,15,0,0,15
6460,USA,Shooting,1996,1,1,1,3
6461,USA,Equestrianism,1996,0,8,5,13
6462,USA,Basketball,1996,24,0,0,24
6463,USA,Cycling,1996,0,2,1,3
6464,USA,Diving,1996,0,0,2,2
6465,USA,Canoeing,1996,0,1,0,1
6466,USA,Beach Volleyball,1996,2,2,0,4
6467,USA,Softball,1996,15,0,0,15
6468,USA,Archery,1996,4,0,0,4
6469,USA,Baseball,1996,0,0,20,20
6470,USA,Gymnastics,1996,8,2,1,11
6471,USA,Synchronized Swimming,1996,10,0,0,10
6472,USA,Taekwondo,2000,1,0,0,1
6473,USA,Sailing,2000,2,4,2,8
6474,USA,Rowing,2000,0,2,4,6
6475,USA,Tennis,2000,3,0,1,4
6476,USA,Weightlifting,2000,1,0,1,2
6477,USA,Wrestling,2000,2,2,3,7
6478,USA,Boxing,2000,0,2,2,4
6479,USA,Athletics,2000,16,4,8,28
6480,USA,Swimming,2000,37,18,11,66
6481,USA,Football,2000,0,13,0,13
6482,USA,Shooting,2000,1,0,2,3
6483,USA,Equestrianism,2000,1,0,8,9
6484,USA,Basketball,2000,23,0,0,23
6485,USA,Cycling,2000,1,1,0,2
6486,USA,Diving,2000,1,0,0,1
6487,USA,Beach Volleyball,2000,2,0,0,2
6488,USA,Softball,2000,15,0,0,15
6489,USA,Archery,2000,0,1,3,4
6490,USA,Water Polo,2000,0,13,0,13
6491,USA,Baseball,2000,24,0,0,24
6492,USA,Modern Pentathlon,2000,0,1,0,1
6493,USA,Gymnastics,2000,0,0,6,6
6494,USA,Taekwondo,2004,1,1,0,2
6495,USA,Sailing,2004,2,2,0,4
6496,USA,Rowing,2004,9,9,0,18
6497,USA,Tennis,2004,0,1,0,1
6498,USA,Wrestling,2004,1,3,2,6
6499,USA,Boxing,2004,1,0,1,2
6500,USA,Athletics,2004,18,15,5,38
6501,USA,Judo,2004,0,0,1,1
6502,USA,Swimming,2004,30,22,13,65
6503,USA,Fencing,2004,1,0,1,2
6504,USA,Football,2004,17,0,0,17
6505,USA,Shooting,2004,2,1,0,3
6506,USA,Equestrianism,2004,4,2,9,15
6507,USA,Basketball,2004,12,0,12,24
6508,USA,Cycling,2004,0,2,0,2
6509,USA,Canoeing,2004,0,1,0,1
6510,USA,Beach Volleyball,2004,2,0,2,4
6511,USA,Softball,2004,15,0,0,15
6512,USA,Triathlon,2004,0,0,1,1
6513,USA,Water Polo,2004,0,0,12,12
6514,USA,Gymnastics,2004,2,16,1,19
6515,USA,Synchronized Swimming,2004,0,0,11,11
6516,USA,Taekwondo,2008,0,1,2,3
6517,USA,Sailing,2008,1,1,0,2
6518,USA,Rowing,2008,9,1,9,19
6519,USA,Tennis,2008,2,0,2,4
6520,USA,Wrestling,2008,1,0,2,3
6521,USA,Boxing,2008,0,0,1,1
6522,USA,Athletics,2008,16,10,6,32
6523,USA,Judo,2008,0,0,1,1
6524,USA,Swimming,2008,31,21,16,68
6525,USA,Fencing,2008,1,8,4,13
6526,USA,Football,2008,17,0,0,17
6527,USA,Shooting,2008,2,2,2,6
6528,USA,Equestrianism,2008,4,1,1,6
6529,USA,Volleyball,2008,12,12,0,24
6530,USA,Basketball,2008,24,0,0,24
6531,USA,Cycling,2008,1,1,3,5
6532,USA,Beach Volleyball,2008,4,0,0,4
6533,USA,Softball,2008,0,15,0,15
6534,USA,Water Polo,2008,0,26,0,26
6535,USA,Baseball,2008,0,0,24,24
6536,USA,Gymnastics,2008,2,11,7,20
6537,USA,Taekwondo,2012,0,0,2,2
6538,USA,Rowing,2012,9,0,8,17
6539,USA,Tennis,2012,5,0,2,7
6540,USA,Wrestling,2012,2,0,2,4
6541,USA,Boxing,2012,1,0,1,2
6542,USA,Athletics,2012,19,16,7,42
6543,USA,Judo,2012,1,0,1,2
6544,USA,Swimming,2012,41,16,11,68
6545,USA,Fencing,2012,0,0,4,4
6546,USA,Football,2012,17,0,0,17
6547,USA,Shooting,2012,3,0,1,4
6548,USA,Volleyball,2012,0,12,0,12
6549,USA,Basketball,2012,24,0,0,24
6550,USA,Cycling,2012,1,5,1,7
6551,USA,Diving,2012,1,2,4,7
6552,USA,Beach Volleyball,2012,2,2,0,4
6553,USA,Archery,2012,0,3,0,3
6554,USA,Water Polo,2012,12,0,0,12
6555,USA,Gymnastics,2012,7,1,2,10
6556,USA,Taekwondo,2016,0,0,1,1
6557,USA,Sailing,2016,0,0,1,1
6558,USA,Rowing,2016,9,1,0,10
6559,USA,Tennis,2016,2,2,2,6
6560,USA,Weightlifting,2016,0,0,1,1
6561,USA,Wrestling,2016,2,0,1,3
6562,USA,Boxing,2016,1,1,1,3
6563,USA,Athletics,2016,27,10,9,46
6564,USA,Judo,2016,1,1,0,2
6565,USA,Swimming,2016,48,14,9,71
6566,USA,Fencing,2016,0,2,8,10
6567,USA,Shooting,2016,1,0,2,3
6568,USA,Equestrianism,2016,0,4,5,9
6569,USA,Volleyball,2016,0,0,24,24
6570,USA,Basketball,2016,24,0,0,24
6571,USA,Cycling,2016,2,6,0,8
6572,USA,Diving,2016,0,4,1,5
6573,USA,Beach Volleyball,2016,0,0,2,2
6574,USA,Archery,2016,0,3,1,4
6575,USA,Triathlon,2016,1,0,0,1
6576,USA,Water Polo,2016,13,0,0,13
6577,USA,Gymnastics,2016,8,6,2,16
6578,USA,Golf,2016,0,0,1,1
6579,USA,Taekwondo,2020,1,0,0,1
6580,USA,Weightlifting,2020,0,1,1,2
6581,USA,Wrestling,2020,3,2,4,9
6582,USA,Boxing,2020,0,3,1,4
6583,USA,Athletics,2020,21,17,14,52
6584,USA,Artistic Gymnastics,2020,2,5,2,9
6585,USA,Swimming,2020,22,22,15,59
6586,USA,Fencing,2020,1,0,4,5
6587,USA,Football,2020,0,0,22,22
6588,USA,Shooting,2020,3,3,2,8
6589,USA,Volleyball,2020,12,0,0,12
6590,USA,Basketball,2020,24,0,0,24
6591,USA,Cycling BMX Freestyle,2020,0,1,0,1
6592,USA,Diving,2020,0,4,1,5
6593,USA,Beach Volleyball,2020,2,0,0,2
6594,USA,Triathlon,2020,0,5,1,6
6595,USA,Water Polo,2020,13,0,0,13
6596,USA,Canoe Sprint,2020,1,0,0,1
6597,USA,Cycling Track,2020,1,0,5,6
6598,USA,Equestrian,2020,0,7,0,7
6599,USA,Skateboarding,2020,0,0,2,2
6600,USA,Surfing,2020,1,0,0,1
6601,USA,Karate,2020,0,0,1,1
6602,USA,Sport Climbing,2020,0,1,0,1
6603,USA,Golf,2020,2,0,0,2
6604,USA,Baseball/Softball,2020,0,39,0,39
6605,USA,3x3 Basketball,2020,4,0,0,4
6606,USA,Taekwondo,2024,0,0,1,1
6607,USA,Sailing,2024,0,0,2,2
6608,USA,Rowing,2024,4,0,9,13
6609,USA,Tennis,2024,0,2,2,4
6610,USA,Weightlifting,2024,1,0,1,2
6611,USA,Wrestling,2024,2,2,3,7
6612,USA,Boxing,2024,0,0,1,1
6613,USA,Athletics,2024,33,16,9,58
6614,USA,Artistic Gymnastics,2024,7,1,9,17
6615,USA,Swimming,2024,27,35,7,69
6616,USA,Fencing,2024,5,1,1,7
6617,USA,Football,2024,20,0,0,20
6618,USA,Shooting,2024,1,4,1,6
6619,USA,Volleyball,2024,0,13,13,26
6620,USA,Basketball,2024,24,0,0,24
6621,USA,Rugby Sevens,2024,0,0,12,12
6622,USA,Cycling BMX Freestyle,2024,0,1,0,1
6623,USA,Diving,2024,0,2,0,2
6624,USA,Archery,2024,0,1,2,3
6625,USA,Water Polo,2024,0,0,13,13
6626,USA,Canoe Slalom,2024,0,0,1,1
6627,USA,Canoe Sprint,2024,0,1,0,1
6628,USA,Cycling Track,2024,5,0,0,5
6629,USA,Equestrian,2024,0,4,0,4
6630,USA,Skateboarding,2024,0,2,1,3
6631,USA,Surfing,2024,1,0,0,1
6632,USA,Sport Climbing,2024,0,1,1,2
6633,USA,Golf,2024,1,0,0,1
6634,USA,Breaking,2024,0,0,1,1
6635,USA,3x3 Basketball,2024,0,0,4,4
6636,USA,Artistic Swimming,2024,0,9,0,9
6637,USA,Cycling Mountain Bike,2024,0,1,0,1
6638,UZB,Boxing,1996,0,0,1,1
6639,UZB,Judo,1996,0,1,0,1
6640,UZB,Wrestling,2000,0,1,0,1
6641,UZB,Boxing,2000,1,0,2,3
6642,UZB,Wrestling,2004,2,1,0,3
6643,UZB,Boxing,2004,0,0,2,2
6644,UZB,Wrestling,2008,1,1,0,2
6645,UZB,Judo,2008,0,1,1,2
6646,UZB,Trampolining,2008,0,0,1,1
6647,UZB,Gymnastics,2008,0,0,1,1
6648,UZB,Wrestling,2012,1,0,0,1
6649,UZB,Boxing,2012,0,0,1,1
6650,UZB,Judo,2012,0,0,1,1
6651,UZB,Weightlifting,2016,1,0,0,1
6652,UZB,Wrestling,2016,0,0,3,3
6653,UZB,Boxing,2016,3,2,2,7
6654,UZB,Judo,2016,0,0,2,2
6655,UZB,Taekwondo,2020,1,0,0,1
6656,UZB,Weightlifting,2020,1,0,0,1
6657,UZB,Wrestling,2020,0,0,1,1
6658,UZB,Boxing,2020,1,0,0,1
6659,UZB,Judo,2020,0,0,1,1
6660,UZB,Taekwondo,2024,1,1,0,2
6661,UZB,Weightlifting,2024,0,1,0,1
6662,UZB,Wrestling,2024,1,0,1,2
6663,UZB,Boxing,2024,5,0,0,5
6664,UZB,Judo,2024,1,0,2,3
6665,VEN,Athletics,1952,0,0,1,1
6666,VEN,Shooting,1960,0,0,1,1
6667,VEN,Boxing,1968,1,0,0,1
6668,VEN,Boxing,1976,0,1,0,1
6669,VEN,Boxing,1980,0,1,0,1
6670,VEN,Boxing,1984,0,0,2,2
6671,VEN,Swimming,1984,0,0,1,1
6672,VEN,Taekwondo,2004,0,0,1,1
6673,VEN,Weightlifting,2004,0,0,1,1
6674,VEN,Taekwondo,2008,0,0,1,1
6675,VEN,Fencing,2012,1,0,0,1
6676,VEN,Boxing,2016,0,0,1,1
6677,VEN,Athletics,2016,0,1,0,1
6678,VEN,Cycling,2016,0,0,1,1
6679,VEN,Weightlifting,2020,0,2,0,2
6680,VEN,Athletics,2020,1,0,0,1
6681,VEN,Cycling BMX Freestyle,2020,0,1,0,1
6682,VIE,Taekwondo,2000,0,1,0,1
6683,VIE,Weightlifting,2008,0,1,0,1
6684,VIE,Shooting,2016,1,1,0,2
6685,WIF,Athletics,1960,0,0,5,5
6686,YUG,Gymnastics,1924,2,0,0,2
6687,YUG,Gymnastics,1928,1,1,10,12
6688,YUG,Gymnastics,1936,0,1,0,1
6689,YUG,Athletics,1948,0,1,0,1
6690,YUG,Football,1948,0,15,0,15
6691,YUG,Rowing,1952,4,0,0,4
6692,YUG,Football,1952,0,11,0,11
6693,YUG,Water Polo,1952,0,9,0,9
6694,YUG,Athletics,1956,0,1,0,1
6695,YUG,Football,1956,0,14,0,14
6696,YUG,Water Polo,1956,0,8,0,8
6697,YUG,Wrestling,1960,0,1,0,1
6698,YUG,Football,1960,16,0,0,16
6699,YUG,Wrestling,1964,1,0,1,2
6700,YUG,Water Polo,1964,0,11,0,11
6701,YUG,Gymnastics,1964,1,0,1,2
6702,YUG,Wrestling,1968,0,1,1,2
6703,YUG,Boxing,1968,0,0,1,1
6704,YUG,Swimming,1968,1,1,0,2
6705,YUG,Basketball,1968,0,12,0,12
6706,YUG,Water Polo,1968,11,0,0,11
6707,YUG,Gymnastics,1968,1,0,0,1
6708,YUG,Wrestling,1972,0,1,1,2
6709,YUG,Boxing,1972,1,0,1,2
6710,YUG,Handball,1972,14,0,0,14
6711,YUG,Wrestling,1976,1,1,0,2
6712,YUG,Boxing,1976,0,1,1,2
6713,YUG,Judo,1976,0,0,1,1
6714,YUG,Basketball,1976,0,12,0,12
6715,YUG,Canoeing,1976,1,0,1,2
6716,YUG,Rowing,1980,0,2,3,5
6717,YUG,Wrestling,1980,0,0,1,1
6718,YUG,Boxing,1980,1,0,0,1
6719,YUG,Judo,1980,0,0,1,1
6720,YUG,Basketball,1980,12,0,12,24
6721,YUG,Water Polo,1980,0,11,0,11
6722,YUG,Handball,1980,0,14,0,14
6723,YUG,Rowing,1984,0,0,2,2
6724,YUG,Wrestling,1984,2,1,2,5
6725,YUG,Boxing,1984,1,1,2,4
6726,YUG,Football,1984,0,0,17,17
6727,YUG,Basketball,1984,0,0,12,12
6728,YUG,Canoeing,1984,2,3,0,5
6729,YUG,Water Polo,1984,13,0,0,13
6730,YUG,Handball,1984,29,0,0,29
6731,YUG,Rowing,1988,0,0,2,2
6732,YUG,Wrestling,1988,0,1,0,1
6733,YUG,Boxing,1988,0,0,1,1
6734,YUG,Shooting,1988,2,0,1,3
6735,YUG,Basketball,1988,0,24,0,24
6736,YUG,Water Polo,1988,13,0,0,13
6737,YUG,Handball,1988,0,0,15,15
6738,YUG,Table Tennis,1988,0,2,2,4
6739,ZAM,Boxing,1984,0,0,1,1
6740,ZAM,Athletics,1996,0,1,0,1
6741,ZAM,Athletics,2024,0,0,1,1
6742,ZIM,Hockey,1980,15,0,0,15
6743,ZIM,Swimming,2004,1,1,1,3
6744,ZIM,Swimming,2008,1,3,0,4
